ProductID,ProductName,ProductCategory,ProductSubCategory,ProductPrice,StockReceived,StockSold,StockOnHand
1,Nathaniel,Electronics,Camera,0.01,475,127,348
2,NonExistentProduct,Electronics,Mobile,847.43,487,243,244
3,Angela,InvalidCategory,Action Figures,386.57,341,188,153
4,Amy,Home & Garden,Decor,364.01,500,124,376
5,Nathaniel,Electronics,Camera,652.35,429,351,78
6,NonExistentProduct,Electronics,Mobile,847.43,79,61,18
7,Justin,Electronics,Headphones,66005.0,339,296,43
8,NonExistentProduct,Electronics,Camera,652.35,305,53,252
9,Shannon,Home & Garden,Gardening Tools,68.01,440,338,102
10,NonExistentProduct,Home & Garden,Decor,364.01,260,254,6
11,Martha,Books,Fiction,43310.0,238,161,77
12,Justin,Electronics,Headphones,660.05,121,13,108
13,Elizabeth,InvalidCategory,Shirt,840.19,290,147,143
14,Jamie,Books,Fiction,930.3,319,94,225
15,NonExistentProduct,Books,Fiction,99999.99,232,3,229
16,Jamie,Books,Fiction,930.3,250,130,120
17,Robert,Electronics,Mobile,847.43,214,113,101
18,Shawn,Electronics,Headphones,46109.0,412,41,371
19,Anthony,Books,Academic,693.39,295,93,202
20,Jamie,Books,Fiction,930.3,356,147,209
21,Pamela,Electronics,Headphones,651.11,457,133,324
22,Elizabeth,Clothing,Shirt,840.19,346,269,77
23,Fred,InvalidCategory,Academic,99999.99,321,104,217
24,NonExistentProduct,Home & Garden,Decor,InvalidPrice,210,10,200
25,Wanda,Toys,Educational,268.61,457,181,276
26,Amy,Home & Garden,Decor,99999.99,253,65,188
27,Wanda,Toys,Educational,268.61,409,46,363
28,Angela,Toys,Action Figures,386.57,486,26,460
29,NonExistentProduct,Books,Academic,951.53,209,47,162
30,Cynthia,Electronics,Headphones,872.85,100,40,60
31,Shawn,Electronics,Headphones,461.09,327,170,157
32,Marvin,Clothing,Shirt,0.01,427,169,258
33,Katie,Books,Non-fiction,642.11,58,38,20
34,Amy,Home & Garden,Decor,InvalidPrice,349,161,188
35,Martha,InvalidCategory,Fiction,433.1,225,192,33
36,NonExistentProduct,Books,Fiction,433.1,312,194,118
37,Pamela,Electronics,Headphones,65111.0,160,157,3
38,Nathaniel,Electronics,Camera,65235.0,147,69,78
39,Angela,InvalidCategory,Action Figures,386.57,322,259,63
40,Cynthia,Electronics,Headphones,872.85,154,35,119
41,NonExistentProduct,InvalidCategory,Dolls,46.23,55,26,29
42,Tammy,InvalidCategory,Furniture,99999.99,438,22,416
43,Pamela,Electronics,Headphones,651.11,280,134,146
44,Nathaniel,Electronics,Camera,99999.99,223,168,55
45,Elizabeth,Clothing,Shirt,840.19,441,107,334
46,Justin,Electronics,Headphones,660.05,143,42,101
47,Shawn,Electronics,Headphones,461.09,154,151,3
48,Martha,Books,Fiction,43310.0,479,105,374
49,Amy,Home & Garden,Decor,0.01,210,18,192
50,Angela,Toys,Action Figures,386.57,142,20,122
51,Marvin,Clothing,Shirt,995.13,211,51,160
52,Michael,InvalidCategory,Dolls,InvalidPrice,427,49,378
53,NonExistentProduct,Clothing,Shirt,995.13,422,187,235
54,Robert,Electronics,Mobile,847.43,471,357,114
55,Shannon,Home & Garden,Gardening Tools,InvalidPrice,500,355,145
56,Tammy,Home & Garden,Furniture,431.82,157,35,122
57,Kristine,Electronics,Headphones,228.82,394,346,48
58,Robert,Electronics,Mobile,84743.0,330,100,230
59,Robert,Electronics,Mobile,84743.0,175,163,12
60,Angela,Toys,Action Figures,386.57,260,158,102
61,Tammy,Home & Garden,Furniture,431.82,491,140,351
62,Martha,InvalidCategory,Fiction,433.1,254,116,138
63,Shannon,Home & Garden,Gardening Tools,68.01,67,52,15
64,NonExistentProduct,Books,Non-fiction,642.11,484,395,89
65,Shawn,InvalidCategory,Headphones,461.09,374,177,197
66,Katie,Books,Non-fiction,642.11,193,102,91
67,Jamie,InvalidCategory,Fiction,930.3,220,73,147
68,Michael,Toys,Dolls,InvalidPrice,286,222,64
69,Cynthia,Electronics,Headphones,872.85,332,223,109
70,Wanda,Toys,Educational,268.61,125,6,119
71,Fred,Books,Academic,99999.99,481,72,409
72,Nathaniel,InvalidCategory,Camera,652.35,281,111,170
73,Shannon,Home & Garden,Gardening Tools,68.01,202,38,164
74,Michael,InvalidCategory,Dolls,46.23,71,11,60
75,Pamela,InvalidCategory,Headphones,651.11,372,189,183
76,Kristine,Electronics,Headphones,22882.0,66,35,31
77,Robert,Electronics,Mobile,847.43,264,200,64
78,NonExistentProduct,Electronics,Camera,652.35,332,301,31
79,NonExistentProduct,Clothing,Shirt,995.13,128,40,88
80,Justin,Electronics,Headphones,660.05,432,346,86
81,Kristine,Electronics,Headphones,228.82,112,82,30
82,NonExistentProduct,Books,Non-fiction,64211.0,487,104,383
83,Michael,Toys,Dolls,46.23,224,211,13
84,Martha,Books,Fiction,433.1,243,235,8
85,Jamie,Books,Fiction,930.3,144,44,100
86,Angela,Toys,Action Figures,386.57,282,191,91
87,Justin,Electronics,Headphones,660.05,496,214,282
88,NonExistentProduct,Books,Academic,693.39,484,281,203
89,Pamela,Electronics,Headphones,651.11,225,138,87
90,Nathaniel,Electronics,Camera,652.35,474,5,469
91,Michael,Toys,Dolls,46.23,483,102,381
92,Michael,Toys,Dolls,InvalidPrice,405,114,291
93,Shannon,Home & Garden,Gardening Tools,68.01,340,34,306
94,Anthony,Books,Academic,693.39,134,43,91
95,Elizabeth,Clothing,Shirt,840.19,221,159,62
96,Marvin,Clothing,Shirt,99513.0,365,122,243
97,Shawn,Electronics,Headphones,461.09,463,121,342
98,Fred,Books,Academic,951.53,417,272,145
99,Fred,InvalidCategory,Academic,951.53,55,40,15
100,Jamie,Books,Fiction,93030.0,381,78,303
101,Anthony,Books,Academic,693.39,71,37,34
102,Pamela,Electronics,Headphones,651.11,400,90,310
103,Shannon,InvalidCategory,Gardening Tools,68.01,106,24,82
104,Tammy,Home & Garden,Furniture,431.82,358,162,196
105,Cynthia,Electronics,Headphones,InvalidPrice,104,92,12
106,Marvin,Clothing,Shirt,99999.99,247,43,204
107,Cynthia,InvalidCategory,Headphones,InvalidPrice,488,459,29
108,Fred,Books,Academic,951.53,411,304,107
109,NonExistentProduct,Clothing,Shirt,995.13,140,114,26
110,Shannon,Home & Garden,Gardening Tools,68.01,293,126,167
111,Tammy,Home & Garden,Furniture,43182.0,175,99,76
112,Katie,Books,Non-fiction,642.11,500,380,120
113,Shawn,Electronics,Headphones,46109.0,411,274,137
114,Nathaniel,Electronics,Camera,652.35,151,115,36
115,Pamela,Electronics,Headphones,651.11,151,61,90
116,Tammy,Home & Garden,Furniture,431.82,362,212,150
117,Marvin,Clothing,Shirt,99513.0,57,18,39
118,Michael,Toys,Dolls,InvalidPrice,414,305,109
119,NonExistentProduct,Electronics,Headphones,660.05,299,27,272
120,Amy,Home & Garden,Decor,364.01,396,272,124
121,Angela,Toys,Action Figures,386.57,313,95,218
122,Amy,Home & Garden,Decor,InvalidPrice,311,28,283
123,Robert,Electronics,Mobile,InvalidPrice,457,445,12
124,Jamie,InvalidCategory,Fiction,93030.0,148,98,50
125,NonExistentProduct,Electronics,Headphones,872.85,452,293,159
126,NonExistentProduct,Toys,Dolls,46.23,276,107,169
127,Shannon,Home & Garden,Gardening Tools,68.01,488,106,382
128,Martha,Books,Fiction,0.01,380,137,243
129,Cynthia,Electronics,Headphones,872.85,439,352,87
130,Fred,Books,Academic,951.53,302,29,273
131,NonExistentProduct,Toys,Dolls,46.23,170,1,169
132,Martha,Books,Fiction,433.1,266,29,237
133,Fred,Books,Academic,951.53,259,8,251
134,Michael,Toys,Dolls,46.23,73,31,42
135,Shawn,Electronics,Headphones,461.09,102,9,93
136,Marvin,Clothing,Shirt,995.13,422,159,263
137,Wanda,InvalidCategory,Educational,99999.99,67,52,15
138,Michael,Toys,Dolls,46.23,284,240,44
139,Cynthia,Electronics,Headphones,872.85,72,57,15
140,Anthony,InvalidCategory,Academic,693.39,131,57,74
141,Kristine,Electronics,Headphones,228.82,140,90,50
142,Cynthia,Electronics,Headphones,99999.99,415,83,332
143,Wanda,Toys,Educational,268.61,210,159,51
144,Jamie,Books,Fiction,930.3,486,358,128
145,Michael,Toys,Dolls,46.23,378,86,292
146,Jamie,Books,Fiction,930.3,263,101,162
147,Martha,Books,Fiction,433.1,122,50,72
148,Marvin,Clothing,Shirt,99513.0,372,76,296
149,Justin,Electronics,Headphones,InvalidPrice,270,170,100
150,Shannon,Home & Garden,Gardening Tools,InvalidPrice,371,62,309
151,Tammy,Home & Garden,Furniture,431.82,262,153,109
152,Robert,Electronics,Mobile,847.43,369,313,56
153,Elizabeth,Clothing,Shirt,840.19,113,28,85
154,Elizabeth,Clothing,Shirt,840.19,216,164,52
155,Kristine,Electronics,Headphones,InvalidPrice,147,12,135
156,Shawn,Electronics,Headphones,461.09,291,153,138
157,Jamie,Books,Fiction,930.3,222,42,180
158,Amy,Home & Garden,Decor,364.01,228,38,190
159,Justin,Electronics,Headphones,0.01,490,301,189
160,Katie,Books,Non-fiction,64211.0,440,54,386
161,NonExistentProduct,Toys,Educational,268.61,163,126,37
162,Nathaniel,InvalidCategory,Camera,652.35,369,165,204
163,Robert,Electronics,Mobile,847.43,455,37,418
164,NonExistentProduct,Books,Non-fiction,642.11,121,23,98
165,Amy,InvalidCategory,Decor,364.01,403,340,63
166,Cynthia,Electronics,Headphones,87285.0,333,156,177
167,Shannon,Home & Garden,Gardening Tools,99999.99,430,410,20
168,Shannon,Home & Garden,Gardening Tools,68.01,258,248,10
169,Kristine,Electronics,Headphones,228.82,282,166,116
170,Shawn,Electronics,Headphones,461.09,312,5,307
171,Anthony,Books,Academic,693.39,262,183,79
172,Pamela,Electronics,Headphones,651.11,439,31,408
173,Katie,Books,Non-fiction,642.11,59,10,49
174,Anthony,Books,Academic,69339.0,354,131,223
175,Marvin,Clothing,Shirt,995.13,106,24,82
176,Amy,Home & Garden,Decor,364.01,460,426,34
177,Justin,Electronics,Headphones,660.05,185,173,12
178,Michael,Toys,Dolls,46.23,420,31,389
179,Amy,Home & Garden,Decor,364.01,371,56,315
180,Kristine,Electronics,Headphones,228.82,222,208,14
181,Elizabeth,Clothing,Shirt,840.19,244,78,166
182,Tammy,Home & Garden,Furniture,431.82,93,29,64
183,Martha,Books,Fiction,433.1,224,82,142
184,Cynthia,Electronics,Headphones,872.85,267,157,110
185,NonExistentProduct,Electronics,Headphones,651.11,220,194,26
186,Elizabeth,Clothing,Shirt,840.19,207,197,10
187,Shannon,Home & Garden,Gardening Tools,99999.99,319,226,93
188,Justin,InvalidCategory,Headphones,660.05,392,189,203
189,Robert,Electronics,Mobile,0.01,488,322,166
190,Tammy,Home & Garden,Furniture,431.82,307,288,19
191,Cynthia,InvalidCategory,Headphones,InvalidPrice,449,291,158
192,Shawn,Electronics,Headphones,461.09,118,51,67
193,Jamie,Books,Fiction,930.3,122,8,114
194,Anthony,Books,Academic,693.39,380,221,159
195,Amy,Home & Garden,Decor,InvalidPrice,106,22,84
196,Pamela,Electronics,Headphones,651.11,143,66,77
197,Angela,Toys,Action Figures,InvalidPrice,156,122,34
198,Pamela,Electronics,Headphones,InvalidPrice,380,251,129
199,Cynthia,Electronics,Headphones,87285.0,231,223,8
200,Marvin,Clothing,Shirt,995.13,289,71,218
201,Shawn,Electronics,Headphones,461.09,228,158,70
202,Katie,Books,Non-fiction,642.11,387,335,52
203,Martha,Books,Fiction,433.1,257,180,77
204,Cynthia,Electronics,Headphones,InvalidPrice,92,8,84
205,Pamela,Electronics,Headphones,65111.0,417,28,389
206,NonExistentProduct,Home & Garden,Furniture,431.82,157,36,121
207,Kristine,Electronics,Headphones,228.82,338,179,159
208,Wanda,Toys,Educational,268.61,239,62,177
209,Angela,Toys,Action Figures,386.57,423,402,21
210,Cynthia,Electronics,Headphones,872.85,290,239,51
211,Martha,Books,Fiction,433.1,132,49,83
212,Nathaniel,Electronics,Camera,0.01,335,88,247
213,Cynthia,Electronics,Headphones,0.01,382,159,223
214,Nathaniel,Electronics,Camera,652.35,484,65,419
215,Shannon,Home & Garden,Gardening Tools,68.01,362,258,104
216,Justin,Electronics,Headphones,660.05,333,231,102
217,Katie,Books,Non-fiction,InvalidPrice,307,246,61
218,Amy,Home & Garden,Decor,36401.0,182,168,14
219,NonExistentProduct,Toys,Educational,268.61,465,201,264
220,Justin,InvalidCategory,Headphones,InvalidPrice,137,8,129
221,Tammy,Home & Garden,Furniture,431.82,133,25,108
222,NonExistentProduct,Toys,Educational,268.61,168,65,103
223,Robert,InvalidCategory,Mobile,84743.0,68,15,53
224,Cynthia,Electronics,Headphones,87285.0,356,55,301
225,Anthony,Books,Academic,693.39,167,36,131
226,Wanda,Toys,Educational,268.61,183,70,113
227,Elizabeth,InvalidCategory,Shirt,840.19,433,374,59
228,Cynthia,Electronics,Headphones,872.85,376,229,147
229,Robert,Electronics,Mobile,0.01,347,324,23
230,NonExistentProduct,Electronics,Headphones,651.11,479,241,238
231,Kristine,Electronics,Headphones,22882.0,260,65,195
232,Michael,Toys,Dolls,46.23,271,218,53
233,Katie,InvalidCategory,Non-fiction,642.11,182,160,22
234,Nathaniel,Electronics,Camera,652.35,450,365,85
235,Anthony,Books,Academic,InvalidPrice,78,49,29
236,Elizabeth,Clothing,Shirt,InvalidPrice,315,200,115
237,Angela,Toys,Action Figures,386.57,477,447,30
238,Angela,InvalidCategory,Action Figures,386.57,53,14,39
239,Shawn,Electronics,Headphones,461.09,115,85,30
240,Kristine,Electronics,Headphones,228.82,162,55,107
241,Martha,Books,Fiction,0.01,497,319,178
242,Anthony,Books,Academic,693.39,154,9,145
243,Kristine,Electronics,Headphones,228.82,400,15,385
244,NonExistentProduct,Electronics,Camera,652.35,357,210,147
245,Angela,Toys,Action Figures,InvalidPrice,271,178,93
246,Martha,Books,Fiction,433.1,386,226,160
247,Tammy,Home & Garden,Furniture,431.82,166,33,133
248,Angela,InvalidCategory,Action Figures,InvalidPrice,438,90,348
249,Shannon,Home & Garden,Gardening Tools,68.01,285,82,203
250,Robert,InvalidCategory,Mobile,847.43,79,29,50
251,Marvin,Clothing,Shirt,99513.0,279,150,129
252,NonExistentProduct,Toys,Educational,268.61,492,234,258
253,Angela,Toys,Action Figures,386.57,263,47,216
254,Kristine,Electronics,Headphones,228.82,114,91,23
255,Marvin,Clothing,Shirt,99513.0,258,213,45
256,Katie,Books,Non-fiction,642.11,143,133,10
257,Kristine,Electronics,Headphones,228.82,307,47,260
258,Amy,Home & Garden,Decor,364.01,234,42,192
259,Kristine,Electronics,Headphones,InvalidPrice,178,119,59
260,Amy,InvalidCategory,Decor,364.01,120,7,113
261,Anthony,Books,Academic,693.39,367,52,315
262,Shawn,Electronics,Headphones,461.09,318,58,260
263,Martha,Books,Fiction,InvalidPrice,424,118,306
264,NonExistentProduct,Books,Fiction,433.1,125,33,92
265,Robert,Electronics,Mobile,84743.0,435,124,311
266,Robert,Electronics,Mobile,InvalidPrice,244,145,99
267,Elizabeth,InvalidCategory,Shirt,840.19,390,160,230
268,Tammy,Home & Garden,Furniture,431.82,458,330,128
269,NonExistentProduct,Books,Academic,693.39,285,269,16
270,Fred,Books,Academic,InvalidPrice,202,133,69
271,Fred,InvalidCategory,Academic,InvalidPrice,435,419,16
272,Kristine,Electronics,Headphones,228.82,444,428,16
273,Cynthia,InvalidCategory,Headphones,872.85,462,22,440
274,Amy,Home & Garden,Decor,364.01,302,6,296
275,Katie,InvalidCategory,Non-fiction,99999.99,447,131,316
276,Angela,Toys,Action Figures,386.57,342,300,42
277,Nathaniel,Electronics,Camera,652.35,163,96,67
278,Kristine,Electronics,Headphones,0.01,184,118,66
279,Amy,Home & Garden,Decor,0.01,338,4,334
280,Nathaniel,InvalidCategory,Camera,0.01,72,65,7
281,NonExistentProduct,Clothing,Shirt,0.01,110,99,11
282,Wanda,Toys,Educational,268.61,339,88,251
283,Katie,Books,Non-fiction,642.11,291,175,116
284,Angela,Toys,Action Figures,386.57,281,150,131
285,Anthony,Books,Academic,0.01,282,89,193
286,Angela,Toys,Action Figures,386.57,176,133,43
287,Jamie,Books,Fiction,0.01,99,68,31
288,Kristine,Electronics,Headphones,228.82,470,397,73
289,Justin,Electronics,Headphones,InvalidPrice,334,114,220
290,Jamie,Books,Fiction,930.3,157,58,99
291,Pamela,Electronics,Headphones,65111.0,312,275,37
292,Jamie,Books,Fiction,930.3,391,385,6
293,Kristine,Electronics,Headphones,0.01,362,25,337
294,Justin,Electronics,Headphones,660.05,210,85,125
295,Katie,Books,Non-fiction,642.11,112,27,85
296,Wanda,Toys,Educational,268.61,351,343,8
297,Kristine,Electronics,Headphones,228.82,260,97,163
298,Amy,Home & Garden,Decor,364.01,316,257,59
299,Cynthia,Electronics,Headphones,872.85,446,439,7
300,Katie,Books,Non-fiction,642.11,223,47,176
301,Michael,Toys,Dolls,46.23,375,273,102
302,Angela,Toys,Action Figures,386.57,63,46,17
303,Anthony,Books,Academic,99999.99,113,103,10
304,Anthony,Books,Academic,693.39,401,260,141
305,Wanda,Toys,Educational,26861.0,339,112,227
306,Justin,Electronics,Headphones,660.05,53,52,1
307,Shawn,Electronics,Headphones,461.09,428,200,228
308,NonExistentProduct,Books,Fiction,930.3,152,6,146
309,Katie,Books,Non-fiction,642.11,131,2,129
310,Pamela,Electronics,Headphones,0.01,393,28,365
311,Angela,Toys,Action Figures,386.57,333,246,87
312,Justin,Electronics,Headphones,660.05,75,38,37
313,Angela,Toys,Action Figures,386.57,256,170,86
314,Michael,Toys,Dolls,46.23,290,195,95
315,Elizabeth,Clothing,Shirt,840.19,457,436,21
316,Justin,Electronics,Headphones,660.05,339,171,168
317,Katie,Books,Non-fiction,99999.99,248,74,174
318,NonExistentProduct,Electronics,Headphones,0.01,120,75,45
319,Jamie,Books,Fiction,930.3,141,39,102
320,Martha,InvalidCategory,Fiction,433.1,142,64,78
321,Marvin,InvalidCategory,Shirt,995.13,472,332,140
322,NonExistentProduct,Home & Garden,Gardening Tools,68.01,351,118,233
323,Amy,InvalidCategory,Decor,364.01,120,78,42
324,Tammy,Home & Garden,Furniture,431.82,416,390,26
325,Michael,Toys,Dolls,46.23,270,181,89
326,Katie,Books,Non-fiction,642.11,483,442,41
327,Elizabeth,Clothing,Shirt,84019.0,171,87,84
328,Michael,Toys,Dolls,InvalidPrice,398,232,166
329,Anthony,Books,Academic,693.39,55,53,2
330,Jamie,Books,Fiction,93030.0,194,178,16
331,Jamie,Books,Fiction,InvalidPrice,293,116,177
332,Tammy,InvalidCategory,Furniture,431.82,299,235,64
333,Amy,Home & Garden,Decor,364.01,333,181,152
334,Nathaniel,InvalidCategory,Camera,652.35,168,134,34
335,Anthony,InvalidCategory,Academic,693.39,70,5,65
336,Nathaniel,Electronics,Camera,652.35,105,36,69
337,Nathaniel,Electronics,Camera,InvalidPrice,220,146,74
338,NonExistentProduct,Books,Fiction,930.3,336,196,140
339,NonExistentProduct,Electronics,Headphones,InvalidPrice,205,88,117
340,Angela,Toys,Action Figures,0.01,101,45,56
341,Pamela,Electronics,Headphones,65111.0,207,47,160
342,Shannon,Home & Garden,Gardening Tools,68.01,97,7,90
343,Robert,Electronics,Mobile,847.43,278,99,179
344,Robert,Electronics,Mobile,847.43,265,78,187
345,Angela,Toys,Action Figures,386.57,271,129,142
346,Amy,Home & Garden,Decor,364.01,290,130,160
347,Angela,Toys,Action Figures,386.57,348,152,196
348,Jamie,Books,Fiction,930.3,219,46,173
349,Angela,Toys,Action Figures,38657.0,90,35,55
350,NonExistentProduct,Electronics,Headphones,99999.99,138,31,107
351,Kristine,Electronics,Headphones,228.82,239,144,95
352,Anthony,Books,Academic,693.39,449,191,258
353,Wanda,Toys,Educational,268.61,410,177,233
354,Nathaniel,Electronics,Camera,652.35,188,176,12
355,Shannon,Home & Garden,Gardening Tools,68.01,50,20,30
356,Michael,Toys,Dolls,46.23,332,82,250
357,Shannon,Home & Garden,Gardening Tools,0.01,462,102,360
358,Angela,Toys,Action Figures,386.57,132,24,108
359,Shannon,Home & Garden,Gardening Tools,68.01,163,131,32
360,NonExistentProduct,Books,Fiction,930.3,306,84,222
361,NonExistentProduct,Toys,Action Figures,386.57,374,288,86
362,Marvin,Clothing,Shirt,995.13,455,304,151
363,Katie,Books,Non-fiction,InvalidPrice,219,164,55
364,NonExistentProduct,Electronics,Headphones,228.82,341,56,285
365,Cynthia,Electronics,Headphones,872.85,454,177,277
366,Nathaniel,Electronics,Camera,652.35,345,229,116
367,Anthony,Books,Academic,InvalidPrice,163,160,3
368,Anthony,Books,Academic,693.39,473,311,162
369,Anthony,Books,Academic,693.39,440,321,119
370,Michael,Toys,Dolls,46.23,410,190,220
371,Pamela,InvalidCategory,Headphones,651.11,198,140,58
372,Elizabeth,Clothing,Shirt,840.19,247,43,204
373,Shawn,Electronics,Headphones,0.01,421,177,244
374,Wanda,Toys,Educational,26861.0,366,316,50
375,Robert,Electronics,Mobile,847.43,127,93,34
376,Michael,Toys,Dolls,46.23,94,27,67
377,Justin,Electronics,Headphones,660.05,156,40,116
378,Anthony,Books,Academic,69339.0,186,43,143
379,Amy,Home & Garden,Decor,364.01,295,201,94
380,Martha,Books,Fiction,433.1,296,25,271
381,Tammy,Home & Garden,Furniture,431.82,445,265,180
382,Katie,Books,Non-fiction,642.11,154,133,21
383,Fred,Books,Academic,951.53,465,247,218
384,Wanda,InvalidCategory,Educational,268.61,362,67,295
385,Cynthia,Electronics,Headphones,872.85,257,129,128
386,Robert,InvalidCategory,Mobile,847.43,468,134,334
387,Jamie,InvalidCategory,Fiction,930.3,290,61,229
388,Shannon,Home & Garden,Gardening Tools,68.01,110,4,106
389,Cynthia,Electronics,Headphones,872.85,79,78,1
390,Angela,Toys,Action Figures,386.57,340,317,23
391,Tammy,Home & Garden,Furniture,431.82,386,67,319
392,Shannon,Home & Garden,Gardening Tools,68.01,376,288,88
393,Fred,Books,Academic,951.53,316,312,4
394,Martha,InvalidCategory,Fiction,433.1,337,92,245
395,Angela,Toys,Action Figures,0.01,195,154,41
396,Shawn,Electronics,Headphones,461.09,273,8,265
397,Marvin,Clothing,Shirt,995.13,131,2,129
398,Nathaniel,Electronics,Camera,652.35,189,187,2
399,Anthony,Books,Academic,693.39,403,395,8
400,Cynthia,Electronics,Headphones,InvalidPrice,177,26,151
401,Wanda,Toys,Educational,99999.99,58,39,19
402,Jamie,Books,Fiction,930.3,495,230,265
403,Shannon,Home & Garden,Gardening Tools,68.01,233,46,187
404,Michael,Toys,Dolls,46.23,471,75,396
405,Angela,Toys,Action Figures,38657.0,182,149,33
406,Katie,Books,Non-fiction,99999.99,367,8,359
407,Fred,Books,Academic,99999.99,480,395,85
408,Shawn,Electronics,Headphones,461.09,321,131,190
409,NonExistentProduct,Home & Garden,Gardening Tools,68.01,428,288,140
410,Robert,Electronics,Mobile,847.43,405,377,28
411,Nathaniel,Electronics,Camera,0.01,63,25,38
412,Justin,Electronics,Headphones,660.05,211,50,161
413,Amy,Home & Garden,Decor,364.01,262,195,67
414,Katie,Books,Non-fiction,642.11,407,64,343
415,Kristine,Electronics,Headphones,0.01,428,44,384
416,Robert,Electronics,Mobile,InvalidPrice,482,267,215
417,Katie,Books,Non-fiction,642.11,469,110,359
418,Tammy,Home & Garden,Furniture,431.82,349,128,221
419,Robert,Electronics,Mobile,847.43,434,340,94
420,Anthony,Books,Academic,693.39,70,55,15
421,Anthony,Books,Academic,693.39,423,351,72
422,Tammy,Home & Garden,Furniture,0.01,345,235,110
423,Anthony,Books,Academic,693.39,324,216,108
424,Michael,Toys,Dolls,46.23,427,256,171
425,NonExistentProduct,Clothing,Shirt,0.01,330,321,9
426,Fred,Books,Academic,951.53,130,55,75
427,Jamie,Books,Fiction,930.3,421,333,88
428,NonExistentProduct,Electronics,Headphones,461.09,177,70,107
429,Amy,Home & Garden,Decor,364.01,252,223,29
430,Justin,InvalidCategory,Headphones,660.05,109,38,71
431,Jamie,Books,Fiction,930.3,98,67,31
432,Martha,Books,Fiction,433.1,363,141,222
433,Marvin,InvalidCategory,Shirt,995.13,81,62,19
434,Justin,Electronics,Headphones,660.05,420,372,48
435,Jamie,Books,Fiction,930.3,355,156,199
436,NonExistentProduct,Electronics,Headphones,228.82,465,69,396
437,Cynthia,Electronics,Headphones,872.85,159,100,59
438,NonExistentProduct,Electronics,Headphones,461.09,333,233,100
439,NonExistentProduct,InvalidCategory,Dolls,46.23,396,7,389
440,Marvin,Clothing,Shirt,InvalidPrice,57,23,34
441,Shannon,InvalidCategory,Gardening Tools,InvalidPrice,323,178,145
442,Katie,Books,Non-fiction,642.11,297,293,4
443,Wanda,Toys,Educational,0.01,92,79,13
444,Cynthia,Electronics,Headphones,872.85,313,216,97
445,Marvin,Clothing,Shirt,99999.99,401,3,398
446,Marvin,Clothing,Shirt,995.13,448,299,149
447,Katie,Books,Non-fiction,InvalidPrice,395,154,241
448,Justin,Electronics,Headphones,660.05,496,187,309
449,Marvin,Clothing,Shirt,995.13,340,200,140
450,NonExistentProduct,Electronics,Headphones,651.11,183,165,18
451,Angela,Toys,Action Figures,InvalidPrice,325,99,226
452,Anthony,Books,Academic,693.39,62,10,52
453,Nathaniel,Electronics,Camera,0.01,184,158,26
454,Pamela,InvalidCategory,Headphones,651.11,262,173,89
455,Marvin,Clothing,Shirt,99513.0,93,67,26
456,Michael,Toys,Dolls,46.23,104,21,83
457,Michael,InvalidCategory,Dolls,46.23,404,4,400
458,Marvin,InvalidCategory,Shirt,99513.0,77,62,15
459,Amy,Home & Garden,Decor,364.01,199,175,24
460,Marvin,Clothing,Shirt,995.13,198,43,155
461,Amy,Home & Garden,Decor,364.01,351,93,258
462,Wanda,InvalidCategory,Educational,InvalidPrice,333,307,26
463,Elizabeth,Clothing,Shirt,840.19,87,64,23
464,Anthony,Books,Academic,693.39,118,104,14
465,Justin,Electronics,Headphones,InvalidPrice,361,187,174
466,Shawn,InvalidCategory,Headphones,461.09,152,68,84
467,Shawn,Electronics,Headphones,461.09,160,115,45
468,Kristine,Electronics,Headphones,22882.0,436,237,199
469,Shawn,Electronics,Headphones,461.09,464,25,439
470,Elizabeth,InvalidCategory,Shirt,0.01,126,119,7
471,Amy,Home & Garden,Decor,364.01,496,80,416
472,Cynthia,Electronics,Headphones,InvalidPrice,324,307,17
473,Katie,Books,Non-fiction,642.11,454,30,424
474,Anthony,Books,Academic,693.39,122,12,110
475,Katie,Books,Non-fiction,642.11,325,142,183
476,Nathaniel,Electronics,Camera,99999.99,430,43,387
477,Justin,Electronics,Headphones,660.05,341,239,102
478,Cynthia,Electronics,Headphones,872.85,190,20,170
479,Angela,Toys,Action Figures,386.57,312,10,302
480,NonExistentProduct,Books,Fiction,930.3,77,69,8
481,Fred,Books,Academic,InvalidPrice,107,81,26
482,Shannon,Home & Garden,Gardening Tools,68.01,84,2,82
483,Marvin,Clothing,Shirt,99999.99,148,81,67
484,Angela,Toys,Action Figures,386.57,51,42,9
485,Robert,Electronics,Mobile,InvalidPrice,366,211,155
486,Michael,Toys,Dolls,46.23,53,26,27
487,Kristine,Electronics,Headphones,228.82,183,182,1
488,NonExistentProduct,InvalidCategory,Non-fiction,642.11,468,418,50
489,Michael,Toys,Dolls,46.23,230,147,83
490,Nathaniel,Electronics,Camera,652.35,74,8,66
491,Cynthia,Electronics,Headphones,872.85,164,55,109
492,Justin,Electronics,Headphones,660.05,364,362,2
493,Shannon,Home & Garden,Gardening Tools,InvalidPrice,443,84,359
494,Pamela,Electronics,Headphones,651.11,283,157,126
495,Michael,Toys,Dolls,46.23,141,52,89
496,Cynthia,Electronics,Headphones,872.85,388,370,18
497,Shannon,Home & Garden,Gardening Tools,6801.000000000001,364,249,115
498,Wanda,Toys,Educational,268.61,70,39,31
499,Nathaniel,Electronics,Camera,652.35,447,108,339
500,Wanda,Toys,Educational,268.61,133,98,35
501,Tammy,Home & Garden,Furniture,431.82,317,99,218
502,Tammy,Home & Garden,Furniture,99999.99,338,307,31
503,Katie,Books,Non-fiction,642.11,379,98,281
504,Kristine,Electronics,Headphones,228.82,402,11,391
505,Tammy,Home & Garden,Furniture,431.82,312,7,305
506,Kristine,Electronics,Headphones,228.82,227,94,133
507,Angela,Toys,Action Figures,386.57,173,102,71
508,Elizabeth,Clothing,Shirt,840.19,366,290,76
509,Wanda,Toys,Educational,InvalidPrice,348,18,330
510,Michael,Toys,Dolls,46.23,290,96,194
511,Robert,Electronics,Mobile,847.43,239,129,110
512,NonExistentProduct,Home & Garden,Furniture,431.82,148,71,77
513,Anthony,Books,Academic,69339.0,337,82,255
514,Wanda,Toys,Educational,268.61,232,79,153
515,Wanda,Toys,Educational,268.61,252,200,52
516,Anthony,Books,Academic,693.39,211,177,34
517,Michael,Toys,Dolls,46.23,324,280,44
518,Jamie,Books,Fiction,0.01,103,28,75
519,Shannon,Home & Garden,Gardening Tools,68.01,360,345,15
520,Robert,Electronics,Mobile,847.43,157,58,99
521,Shawn,Electronics,Headphones,461.09,478,439,39
522,Shannon,Home & Garden,Gardening Tools,68.01,147,143,4
523,Cynthia,InvalidCategory,Headphones,InvalidPrice,380,355,25
524,Katie,Books,Non-fiction,642.11,86,83,3
525,Cynthia,Electronics,Headphones,872.85,207,162,45
526,Cynthia,Electronics,Headphones,872.85,439,430,9
527,Elizabeth,Clothing,Shirt,840.19,206,85,121
528,Wanda,Toys,Educational,0.01,131,126,5
529,Justin,Electronics,Headphones,660.05,161,130,31
530,Martha,Books,Fiction,433.1,258,245,13
531,Robert,Electronics,Mobile,847.43,71,7,64
532,Martha,Books,Fiction,43310.0,127,42,85
533,NonExistentProduct,Electronics,Headphones,66005.0,191,46,145
534,Pamela,Electronics,Headphones,65111.0,81,14,67
535,Robert,Electronics,Mobile,847.43,482,473,9
536,Cynthia,Electronics,Headphones,872.85,92,6,86
537,Nathaniel,Electronics,Camera,652.35,409,211,198
538,Robert,InvalidCategory,Mobile,847.43,397,162,235
539,Tammy,Home & Garden,Furniture,431.82,270,9,261
540,Robert,InvalidCategory,Mobile,847.43,258,167,91
541,Elizabeth,Clothing,Shirt,840.19,225,38,187
542,Tammy,InvalidCategory,Furniture,431.82,458,151,307
543,Katie,Books,Non-fiction,642.11,108,14,94
544,Katie,Books,Non-fiction,642.11,472,325,147
545,Shannon,Home & Garden,Gardening Tools,68.01,303,76,227
546,Martha,Books,Fiction,99999.99,262,220,42
547,Kristine,Electronics,Headphones,228.82,287,105,182
548,Pamela,Electronics,Headphones,651.11,183,79,104
549,Tammy,Home & Garden,Furniture,431.82,104,7,97
550,Katie,InvalidCategory,Non-fiction,64211.0,499,54,445
551,Jamie,Books,Fiction,930.3,307,94,213
552,Cynthia,Electronics,Headphones,872.85,188,17,171
553,Wanda,Toys,Educational,268.61,303,7,296
554,Michael,Toys,Dolls,46.23,237,237,0
555,Elizabeth,Clothing,Shirt,840.19,437,245,192
556,Anthony,Books,Academic,693.39,74,36,38
557,Pamela,Electronics,Headphones,651.11,200,166,34
558,Jamie,Books,Fiction,930.3,443,203,240
559,NonExistentProduct,Books,Fiction,930.3,214,9,205
560,Shawn,Electronics,Headphones,461.09,150,128,22
561,Jamie,InvalidCategory,Fiction,930.3,195,143,52
562,Shawn,Electronics,Headphones,461.09,351,252,99
563,Justin,Electronics,Headphones,InvalidPrice,490,14,476
564,Shannon,Home & Garden,Gardening Tools,68.01,337,231,106
565,Martha,InvalidCategory,Fiction,433.1,148,114,34
566,Robert,Electronics,Mobile,847.43,233,87,146
567,Justin,Electronics,Headphones,660.05,482,27,455
568,Wanda,Toys,Educational,InvalidPrice,67,56,11
569,Jamie,Books,Fiction,InvalidPrice,333,86,247
570,Kristine,Electronics,Headphones,228.82,378,249,129
571,Fred,Books,Academic,951.53,352,97,255
572,Amy,InvalidCategory,Decor,InvalidPrice,489,90,399
573,Amy,Home & Garden,Decor,364.01,196,15,181
574,Tammy,Home & Garden,Furniture,431.82,466,213,253
575,Katie,Books,Non-fiction,0.01,320,34,286
576,Wanda,Toys,Educational,99999.99,128,74,54
577,NonExistentProduct,InvalidCategory,Academic,InvalidPrice,352,159,193
578,NonExistentProduct,Books,Fiction,930.3,432,173,259
579,Michael,Toys,Dolls,46.23,326,211,115
580,Fred,Books,Academic,951.53,313,39,274
581,Martha,InvalidCategory,Fiction,InvalidPrice,384,188,196
582,Shawn,Electronics,Headphones,InvalidPrice,487,341,146
583,Katie,Books,Non-fiction,642.11,81,53,28
584,Kristine,Electronics,Headphones,228.82,168,6,162
585,Shannon,Home & Garden,Gardening Tools,68.01,372,173,199
586,Katie,InvalidCategory,Non-fiction,642.11,206,172,34
587,Jamie,Books,Fiction,930.3,205,35,170
588,Wanda,Toys,Educational,268.61,175,127,48
589,Marvin,Clothing,Shirt,995.13,336,75,261
590,Elizabeth,Clothing,Shirt,InvalidPrice,262,240,22
591,NonExistentProduct,Electronics,Mobile,84743.0,452,236,216
592,Angela,Toys,Action Figures,386.57,419,151,268
593,Nathaniel,Electronics,Camera,65235.0,269,8,261
594,Pamela,Electronics,Headphones,InvalidPrice,428,238,190
595,Nathaniel,Electronics,Camera,InvalidPrice,67,39,28
596,Amy,Home & Garden,Decor,364.01,118,110,8
597,Martha,Books,Fiction,433.1,60,16,44
598,NonExistentProduct,Books,Non-fiction,642.11,79,71,8
599,Wanda,InvalidCategory,Educational,268.61,60,15,45
600,Wanda,InvalidCategory,Educational,268.61,209,190,19
601,Tammy,Home & Garden,Furniture,0.01,120,67,53
602,NonExistentProduct,Electronics,Mobile,0.01,448,21,427
603,Kristine,Electronics,Headphones,228.82,130,129,1
604,Anthony,InvalidCategory,Academic,693.39,185,21,164
605,Shannon,InvalidCategory,Gardening Tools,68.01,106,65,41
606,Amy,InvalidCategory,Decor,364.01,146,80,66
607,NonExistentProduct,Books,Academic,951.53,337,190,147
608,Robert,Electronics,Mobile,847.43,159,145,14
609,NonExistentProduct,Home & Garden,Gardening Tools,0.01,125,49,76
610,Shawn,Electronics,Headphones,InvalidPrice,141,77,64
611,Cynthia,Electronics,Headphones,872.85,57,50,7
612,Shawn,Electronics,Headphones,InvalidPrice,159,159,0
613,Michael,Toys,Dolls,46.23,498,270,228
614,Cynthia,Electronics,Headphones,872.85,204,204,0
615,Nathaniel,Electronics,Camera,0.01,332,48,284
616,Angela,Toys,Action Figures,InvalidPrice,203,126,77
617,Katie,InvalidCategory,Non-fiction,642.11,412,230,182
618,Tammy,InvalidCategory,Furniture,InvalidPrice,274,201,73
619,Fred,InvalidCategory,Academic,951.53,122,38,84
620,Michael,Toys,Dolls,46.23,238,80,158
621,Martha,InvalidCategory,Fiction,InvalidPrice,188,150,38
622,Angela,Toys,Action Figures,386.57,210,187,23
623,NonExistentProduct,InvalidCategory,Fiction,433.1,414,409,5
624,Cynthia,Electronics,Headphones,InvalidPrice,247,122,125
625,Angela,Toys,Action Figures,InvalidPrice,56,52,4
626,Michael,Toys,Dolls,99999.99,219,154,65
627,Katie,Books,Non-fiction,642.11,305,232,73
628,Elizabeth,InvalidCategory,Shirt,840.19,221,221,0
629,Marvin,Clothing,Shirt,995.13,230,217,13
630,Shannon,Home & Garden,Gardening Tools,0.01,352,113,239
631,Anthony,Books,Academic,693.39,270,150,120
632,Shawn,Electronics,Headphones,461.09,73,63,10
633,Tammy,Home & Garden,Furniture,0.01,222,50,172
634,Jamie,Books,Fiction,930.3,331,17,314
635,Justin,Electronics,Headphones,660.05,465,294,171
636,Anthony,Books,Academic,693.39,442,152,290
637,Anthony,Books,Academic,693.39,348,248,100
638,Fred,Books,Academic,951.53,213,55,158
639,Elizabeth,Clothing,Shirt,InvalidPrice,384,357,27
640,Michael,Toys,Dolls,0.01,252,245,7
641,Marvin,InvalidCategory,Shirt,995.13,306,305,1
642,Marvin,Clothing,Shirt,995.13,354,332,22
643,Nathaniel,Electronics,Camera,652.35,295,167,128
644,Shawn,Electronics,Headphones,461.09,294,209,85
645,Wanda,Toys,Educational,268.61,370,349,21
646,Kristine,InvalidCategory,Headphones,228.82,281,190,91
647,Anthony,Books,Academic,InvalidPrice,185,67,118
648,Justin,Electronics,Headphones,660.05,378,354,24
649,NonExistentProduct,Books,Academic,951.53,251,131,120
650,Amy,Home & Garden,Decor,364.01,134,19,115
651,Angela,Toys,Action Figures,386.57,334,142,192
652,Cynthia,Electronics,Headphones,872.85,477,420,57
653,NonExistentProduct,Electronics,Mobile,847.43,176,33,143
654,Angela,Toys,Action Figures,386.57,364,17,347
655,Elizabeth,Clothing,Shirt,0.01,270,130,140
656,Amy,Home & Garden,Decor,0.01,441,369,72
657,Robert,Electronics,Mobile,847.43,197,87,110
658,Pamela,Electronics,Headphones,651.11,118,90,28
659,Cynthia,InvalidCategory,Headphones,872.85,332,249,83
660,Nathaniel,Electronics,Camera,652.35,376,270,106
661,Nathaniel,Electronics,Camera,652.35,294,37,257
662,NonExistentProduct,InvalidCategory,Decor,364.01,377,18,359
663,Elizabeth,Clothing,Shirt,840.19,233,167,66
664,Jamie,Books,Fiction,930.3,489,87,402
665,Angela,Toys,Action Figures,386.57,346,131,215
666,Amy,Home & Garden,Decor,364.01,114,7,107
667,Angela,Toys,Action Figures,386.57,497,281,216
668,Nathaniel,Electronics,Camera,652.35,403,259,144
669,Shannon,Home & Garden,Gardening Tools,InvalidPrice,210,85,125
670,Martha,Books,Fiction,433.1,332,66,266
671,Justin,Electronics,Headphones,66005.0,60,60,0
672,Shannon,InvalidCategory,Gardening Tools,68.01,432,372,60
673,Robert,Electronics,Mobile,84743.0,252,146,106
674,Robert,Electronics,Mobile,99999.99,158,65,93
675,NonExistentProduct,Electronics,Headphones,228.82,479,214,265
676,Angela,Toys,Action Figures,99999.99,296,260,36
677,Jamie,Books,Fiction,930.3,324,86,238
678,NonExistentProduct,Toys,Action Figures,386.57,463,167,296
679,Anthony,Books,Academic,693.39,454,334,120
680,Martha,Books,Fiction,433.1,63,50,13
681,NonExistentProduct,Electronics,Headphones,872.85,491,351,140
682,Michael,Toys,Dolls,InvalidPrice,79,55,24
683,Shannon,Home & Garden,Gardening Tools,0.01,78,5,73
684,Anthony,InvalidCategory,Academic,693.39,105,22,83
685,NonExistentProduct,Electronics,Headphones,228.82,265,77,188
686,Michael,Toys,Dolls,46.23,211,84,127
687,Martha,Books,Fiction,433.1,268,115,153
688,Fred,Books,Academic,951.53,406,375,31
689,Shawn,Electronics,Headphones,461.09,227,99,128
690,Shannon,Home & Garden,Gardening Tools,99999.99,459,400,59
691,Fred,Books,Academic,951.53,401,162,239
692,Kristine,Electronics,Headphones,InvalidPrice,351,323,28
693,Martha,Books,Fiction,433.1,91,23,68
694,Martha,Books,Fiction,433.1,491,383,108
695,Jamie,Books,Fiction,930.3,346,60,286
696,Martha,Books,Fiction,433.1,376,123,253
697,Jamie,InvalidCategory,Fiction,930.3,164,33,131
698,Michael,Toys,Dolls,4623.0,492,281,211
699,Nathaniel,Electronics,Camera,652.35,301,128,173
700,Anthony,Books,Academic,InvalidPrice,142,84,58
701,Justin,Electronics,Headphones,660.05,229,222,7
702,Marvin,Clothing,Shirt,995.13,138,35,103
703,Shawn,Electronics,Headphones,99999.99,336,32,304
704,Elizabeth,Clothing,Shirt,840.19,362,140,222
705,NonExistentProduct,Books,Academic,69339.0,275,45,230
706,NonExistentProduct,InvalidCategory,Academic,951.53,115,86,29
707,Shannon,Home & Garden,Gardening Tools,68.01,137,52,85
708,Tammy,Home & Garden,Furniture,431.82,372,134,238
709,NonExistentProduct,Electronics,Headphones,651.11,99,15,84
710,Shannon,Home & Garden,Gardening Tools,68.01,403,14,389
711,Michael,Toys,Dolls,46.23,207,203,4
712,Nathaniel,Electronics,Camera,652.35,338,89,249
713,NonExistentProduct,Electronics,Headphones,228.82,372,329,43
714,Tammy,Home & Garden,Furniture,431.82,55,13,42
715,Elizabeth,Clothing,Shirt,840.19,328,3,325
716,Angela,Toys,Action Figures,386.57,408,48,360
717,Kristine,Electronics,Headphones,228.82,446,274,172
718,Justin,Electronics,Headphones,660.05,51,42,9
719,NonExistentProduct,Electronics,Mobile,847.43,315,122,193
720,NonExistentProduct,Home & Garden,Furniture,0.01,495,308,187
721,Fred,Books,Academic,951.53,131,49,82
722,Cynthia,InvalidCategory,Headphones,0.01,250,165,85
723,Amy,Home & Garden,Decor,InvalidPrice,227,183,44
724,NonExistentProduct,Home & Garden,Gardening Tools,68.01,194,14,180
725,Robert,Electronics,Mobile,847.43,137,100,37
726,NonExistentProduct,Books,Non-fiction,642.11,185,175,10
727,Shannon,Home & Garden,Gardening Tools,0.01,215,124,91
728,Cynthia,Electronics,Headphones,872.85,103,64,39
729,Tammy,Home & Garden,Furniture,431.82,378,71,307
730,Martha,Books,Fiction,433.1,384,30,354
731,NonExistentProduct,Toys,Educational,268.61,335,317,18
732,NonExistentProduct,InvalidCategory,Dolls,46.23,409,408,1
733,Amy,Home & Garden,Decor,364.01,382,108,274
734,NonExistentProduct,Toys,Action Figures,386.57,426,34,392
735,Michael,Toys,Dolls,4623.0,403,245,158
736,Amy,Home & Garden,Decor,364.01,59,2,57
737,Michael,Toys,Dolls,46.23,435,62,373
738,Cynthia,Electronics,Headphones,872.85,441,113,328
739,Tammy,InvalidCategory,Furniture,431.82,309,169,140
740,Pamela,Electronics,Headphones,651.11,273,198,75
741,Martha,Books,Fiction,433.1,396,294,102
742,Kristine,Electronics,Headphones,228.82,138,137,1
743,Shannon,Home & Garden,Gardening Tools,68.01,390,20,370
744,Cynthia,Electronics,Headphones,InvalidPrice,82,17,65
745,Tammy,Home & Garden,Furniture,43182.0,442,20,422
746,NonExistentProduct,Clothing,Shirt,995.13,171,10,161
747,Michael,Toys,Dolls,46.23,491,469,22
748,Elizabeth,Clothing,Shirt,840.19,65,29,36
749,Justin,Electronics,Headphones,660.05,233,62,171
750,Kristine,Electronics,Headphones,228.82,300,271,29
751,Kristine,Electronics,Headphones,228.82,165,73,92
752,Katie,Books,Non-fiction,InvalidPrice,424,89,335
753,Tammy,Home & Garden,Furniture,431.82,426,171,255
754,Anthony,Books,Academic,99999.99,72,67,5
755,Justin,Electronics,Headphones,660.05,282,39,243
756,Fred,Books,Academic,951.53,151,62,89
757,Angela,Toys,Action Figures,38657.0,418,376,42
758,Robert,Electronics,Mobile,0.01,211,154,57
759,Cynthia,Electronics,Headphones,872.85,187,7,180
760,Elizabeth,Clothing,Shirt,84019.0,499,49,450
761,NonExistentProduct,Electronics,Camera,652.35,430,384,46
762,Katie,Books,Non-fiction,642.11,72,14,58
763,Kristine,Electronics,Headphones,228.82,185,31,154
764,Pamela,Electronics,Headphones,651.11,340,303,37
765,Justin,Electronics,Headphones,660.05,494,248,246
766,NonExistentProduct,Books,Non-fiction,642.11,214,40,174
767,Angela,Toys,Action Figures,38657.0,133,86,47
768,Jamie,Books,Fiction,InvalidPrice,234,133,101
769,Wanda,Toys,Educational,268.61,411,133,278
770,Shawn,Electronics,Headphones,461.09,313,295,18
771,Justin,Electronics,Headphones,InvalidPrice,245,113,132
772,Cynthia,Electronics,Headphones,872.85,380,349,31
773,Amy,Home & Garden,Decor,364.01,220,27,193
774,Cynthia,Electronics,Headphones,872.85,154,148,6
775,Nathaniel,Electronics,Camera,652.35,77,71,6
776,Katie,Books,Non-fiction,0.01,55,52,3
777,Nathaniel,Electronics,Camera,652.35,201,128,73
778,Nathaniel,InvalidCategory,Camera,0.01,129,118,11
779,Michael,InvalidCategory,Dolls,99999.99,369,215,154
780,Katie,Books,Non-fiction,642.11,383,209,174
781,Elizabeth,Clothing,Shirt,840.19,154,152,2
782,Wanda,Toys,Educational,InvalidPrice,90,85,5
783,Justin,Electronics,Headphones,99999.99,57,1,56
784,Justin,Electronics,Headphones,660.05,335,310,25
785,Fred,Books,Academic,0.01,78,5,73
786,Angela,Toys,Action Figures,0.01,171,118,53
787,Elizabeth,Clothing,Shirt,840.19,308,150,158
788,Justin,Electronics,Headphones,660.05,127,78,49
789,Katie,InvalidCategory,Non-fiction,0.01,260,216,44
790,Katie,Books,Non-fiction,0.01,314,176,138
791,Tammy,Home & Garden,Furniture,431.82,369,183,186
792,Elizabeth,Clothing,Shirt,840.19,429,302,127
793,Wanda,Toys,Educational,26861.0,60,29,31
794,Justin,Electronics,Headphones,660.05,315,244,71
795,Shawn,Electronics,Headphones,461.09,453,51,402
796,Jamie,Books,Fiction,InvalidPrice,124,66,58
797,Wanda,Toys,Educational,268.61,108,71,37
798,Justin,Electronics,Headphones,0.01,313,91,222
799,NonExistentProduct,Electronics,Headphones,228.82,115,57,58
800,Robert,Electronics,Mobile,84743.0,314,227,87
801,Justin,InvalidCategory,Headphones,660.05,397,40,357
802,Wanda,Toys,Educational,268.61,247,141,106
803,Wanda,Toys,Educational,268.61,290,22,268
804,Pamela,Electronics,Headphones,65111.0,362,160,202
805,Amy,Home & Garden,Decor,364.01,221,108,113
806,Cynthia,Electronics,Headphones,87285.0,53,34,19
807,Michael,Toys,Dolls,4623.0,345,133,212
808,Wanda,Toys,Educational,26861.0,132,20,112
809,Fred,Books,Academic,InvalidPrice,393,364,29
810,NonExistentProduct,Electronics,Headphones,228.82,372,86,286
811,Pamela,Electronics,Headphones,65111.0,456,114,342
812,Elizabeth,Clothing,Shirt,840.19,145,117,28
813,NonExistentProduct,Electronics,Headphones,228.82,473,292,181
814,Shannon,Home & Garden,Gardening Tools,68.01,401,312,89
815,Fred,Books,Academic,951.53,364,329,35
816,Amy,Home & Garden,Decor,InvalidPrice,245,25,220
817,Wanda,Toys,Educational,26861.0,141,42,99
818,Fred,Books,Academic,951.53,338,332,6
819,Shannon,Home & Garden,Gardening Tools,68.01,226,35,191
820,Kristine,Electronics,Headphones,99999.99,268,64,204
821,Michael,Toys,Dolls,46.23,280,121,159
822,Anthony,InvalidCategory,Academic,69339.0,403,142,261
823,Robert,Electronics,Mobile,0.01,500,155,345
824,Shannon,Home & Garden,Gardening Tools,68.01,311,262,49
825,Robert,Electronics,Mobile,84743.0,240,118,122
826,Jamie,Books,Fiction,930.3,196,61,135
827,Elizabeth,Clothing,Shirt,84019.0,437,424,13
828,Wanda,Toys,Educational,268.61,246,87,159
829,Wanda,Toys,Educational,268.61,218,25,193
830,Marvin,Clothing,Shirt,99513.0,428,89,339
831,Anthony,Books,Academic,693.39,445,393,52
832,Pamela,Electronics,Headphones,651.11,78,60,18
833,NonExistentProduct,Books,Academic,69339.0,206,58,148
834,Kristine,Electronics,Headphones,228.82,340,298,42
835,NonExistentProduct,Home & Garden,Decor,364.01,99,84,15
836,Angela,Toys,Action Figures,386.57,277,231,46
837,Kristine,Electronics,Headphones,228.82,464,274,190
838,Cynthia,Electronics,Headphones,872.85,473,34,439
839,Fred,Books,Academic,951.53,280,246,34
840,Michael,Toys,Dolls,46.23,266,141,125
841,NonExistentProduct,Books,Academic,0.01,131,52,79
842,Elizabeth,Clothing,Shirt,840.19,382,23,359
843,Tammy,Home & Garden,Furniture,43182.0,373,112,261
844,Wanda,Toys,Educational,268.61,278,179,99
845,Justin,Electronics,Headphones,66005.0,106,53,53
846,Anthony,Books,Academic,693.39,383,206,177
847,Marvin,Clothing,Shirt,995.13,198,82,116
848,Amy,Home & Garden,Decor,364.01,268,8,260
849,Pamela,Electronics,Headphones,651.11,50,16,34
850,Fred,Books,Academic,951.53,74,60,14
851,Elizabeth,Clothing,Shirt,InvalidPrice,380,85,295
852,Amy,Home & Garden,Decor,364.01,216,62,154
853,Martha,Books,Fiction,433.1,407,167,240
854,Michael,Toys,Dolls,46.23,458,269,189
855,Pamela,Electronics,Headphones,651.11,89,85,4
856,Wanda,Toys,Educational,268.61,158,19,139
857,NonExistentProduct,Electronics,Camera,652.35,472,126,346
858,Nathaniel,Electronics,Camera,652.35,284,128,156
859,Cynthia,Electronics,Headphones,872.85,386,50,336
860,Fred,Books,Academic,951.53,257,162,95
861,Kristine,Electronics,Headphones,228.82,433,9,424
862,Shawn,Electronics,Headphones,InvalidPrice,62,61,1
863,Wanda,InvalidCategory,Educational,268.61,474,228,246
864,Shannon,Home & Garden,Gardening Tools,68.01,455,287,168
865,Michael,Toys,Dolls,0.01,64,23,41
866,Shannon,Home & Garden,Gardening Tools,68.01,443,136,307
867,Tammy,Home & Garden,Furniture,99999.99,290,55,235
868,Nathaniel,Electronics,Camera,652.35,221,135,86
869,Cynthia,Electronics,Headphones,872.85,364,164,200
870,Anthony,InvalidCategory,Academic,693.39,427,422,5
871,Anthony,Books,Academic,693.39,198,187,11
872,Angela,Toys,Action Figures,386.57,456,355,101
873,Shawn,Electronics,Headphones,InvalidPrice,483,281,202
874,Pamela,Electronics,Headphones,651.11,98,1,97
875,NonExistentProduct,Books,Non-fiction,0.01,413,100,313
876,Fred,Books,Academic,951.53,147,28,119
877,Kristine,Electronics,Headphones,228.82,280,148,132
878,Robert,Electronics,Mobile,847.43,203,191,12
879,Cynthia,InvalidCategory,Headphones,99999.99,194,135,59
880,Katie,Books,Non-fiction,642.11,385,200,185
881,Tammy,Home & Garden,Furniture,431.82,486,172,314
882,Wanda,Toys,Educational,268.61,447,64,383
883,Shawn,Electronics,Headphones,46109.0,262,192,70
884,Elizabeth,Clothing,Shirt,84019.0,393,222,171
885,Shawn,Electronics,Headphones,461.09,211,48,163
886,Nathaniel,Electronics,Camera,652.35,279,249,30
887,Tammy,InvalidCategory,Furniture,431.82,122,37,85
888,Martha,Books,Fiction,InvalidPrice,249,39,210
889,Tammy,Home & Garden,Furniture,99999.99,346,37,309
890,Fred,Books,Academic,95153.0,384,334,50
891,Michael,Toys,Dolls,46.23,90,70,20
892,Amy,Home & Garden,Decor,364.01,463,258,205
893,Nathaniel,Electronics,Camera,65235.0,464,188,276
894,Kristine,Electronics,Headphones,228.82,112,10,102
895,Cynthia,Electronics,Headphones,InvalidPrice,66,57,9
896,Amy,Home & Garden,Decor,99999.99,459,290,169
897,Pamela,Electronics,Headphones,651.11,389,232,157
898,Fred,InvalidCategory,Academic,951.53,149,140,9
899,NonExistentProduct,Books,Fiction,93030.0,142,15,127
900,NonExistentProduct,Home & Garden,Furniture,431.82,308,139,169
901,Wanda,Toys,Educational,268.61,345,305,40
902,Tammy,InvalidCategory,Furniture,431.82,374,23,351
903,Kristine,Electronics,Headphones,InvalidPrice,304,173,131
904,Shawn,Electronics,Headphones,461.09,402,135,267
905,Justin,Electronics,Headphones,660.05,131,36,95
906,Wanda,Toys,Educational,26861.0,53,45,8
907,Kristine,Electronics,Headphones,228.82,468,206,262
908,Michael,Toys,Dolls,46.23,65,3,62
909,Amy,Home & Garden,Decor,364.01,203,103,100
910,Nathaniel,Electronics,Camera,InvalidPrice,291,85,206
911,NonExistentProduct,Toys,Dolls,46.23,78,26,52
912,Kristine,Electronics,Headphones,228.82,77,23,54
913,Angela,InvalidCategory,Action Figures,386.57,453,257,196
914,Cynthia,Electronics,Headphones,872.85,72,51,21
915,Marvin,Clothing,Shirt,995.13,370,241,129
916,Fred,Books,Academic,951.53,325,7,318
917,Kristine,Electronics,Headphones,228.82,265,47,218
918,NonExistentProduct,InvalidCategory,Academic,InvalidPrice,442,237,205
919,Fred,Books,Academic,951.53,382,311,71
920,Kristine,Electronics,Headphones,228.82,452,391,61
921,Fred,Books,Academic,951.53,396,230,166
922,Jamie,Books,Fiction,0.01,80,61,19
923,Cynthia,Electronics,Headphones,872.85,358,195,163
924,Robert,InvalidCategory,Mobile,0.01,408,328,80
925,Robert,Electronics,Mobile,99999.99,190,9,181
926,Fred,Books,Academic,951.53,255,107,148
927,Fred,Books,Academic,InvalidPrice,308,189,119
928,Shawn,Electronics,Headphones,0.01,470,34,436
929,Fred,Books,Academic,951.53,377,129,248
930,Cynthia,Electronics,Headphones,872.85,347,99,248
931,Tammy,Home & Garden,Furniture,431.82,117,101,16
932,Shawn,Electronics,Headphones,461.09,202,193,9
933,Michael,Toys,Dolls,46.23,164,159,5
934,Anthony,Books,Academic,693.39,98,72,26
935,Cynthia,Electronics,Headphones,InvalidPrice,136,129,7
936,Martha,Books,Fiction,433.1,476,162,314
937,Martha,Books,Fiction,99999.99,226,13,213
938,Robert,Electronics,Mobile,847.43,266,91,175
939,Fred,Books,Academic,951.53,489,53,436
940,Michael,InvalidCategory,Dolls,InvalidPrice,84,14,70
941,Nathaniel,Electronics,Camera,652.35,138,127,11
942,Angela,Toys,Action Figures,0.01,361,303,58
943,Shannon,Home & Garden,Gardening Tools,InvalidPrice,198,125,73
944,Shawn,Electronics,Headphones,461.09,367,23,344
945,NonExistentProduct,InvalidCategory,Educational,26861.0,175,97,78
946,Fred,InvalidCategory,Academic,951.53,145,126,19
947,Robert,Electronics,Mobile,84743.0,459,247,212
948,Tammy,Home & Garden,Furniture,431.82,464,48,416
949,Martha,Books,Fiction,433.1,255,148,107
950,Elizabeth,Clothing,Shirt,99999.99,395,264,131
951,Fred,InvalidCategory,Academic,951.53,447,52,395
952,Pamela,Electronics,Headphones,InvalidPrice,127,55,72
953,Justin,Electronics,Headphones,660.05,275,209,66
954,Wanda,Toys,Educational,268.61,134,127,7
955,NonExistentProduct,Electronics,Mobile,847.43,399,327,72
956,Cynthia,Electronics,Headphones,872.85,195,4,191
957,Michael,Toys,Dolls,InvalidPrice,81,76,5
958,Anthony,Books,Academic,693.39,320,269,51
959,Angela,Toys,Action Figures,386.57,494,124,370
960,Katie,Books,Non-fiction,InvalidPrice,221,74,147
961,Jamie,Books,Fiction,930.3,279,1,278
962,Nathaniel,Electronics,Camera,InvalidPrice,141,48,93
963,Justin,Electronics,Headphones,660.05,156,54,102
964,Shawn,Electronics,Headphones,99999.99,114,77,37
965,Cynthia,Electronics,Headphones,872.85,331,178,153
966,Jamie,Books,Fiction,930.3,138,30,108
967,Angela,Toys,Action Figures,386.57,403,247,156
968,Shawn,Electronics,Headphones,461.09,81,62,19
969,Anthony,Books,Academic,InvalidPrice,138,33,105
970,Elizabeth,Clothing,Shirt,840.19,400,9,391
971,Elizabeth,Clothing,Shirt,840.19,112,65,47
972,NonExistentProduct,Electronics,Camera,InvalidPrice,341,199,142
973,Kristine,Electronics,Headphones,228.82,269,31,238
974,Martha,Books,Fiction,43310.0,387,63,324
975,NonExistentProduct,Electronics,Mobile,847.43,130,128,2
976,Fred,Books,Academic,951.53,397,51,346
977,Martha,Books,Fiction,433.1,366,300,66
978,Marvin,Clothing,Shirt,995.13,327,103,224
979,Fred,Books,Academic,95153.0,253,86,167
980,Wanda,Toys,Educational,268.61,106,36,70
981,Angela,Toys,Action Figures,386.57,408,246,162
982,Anthony,Books,Academic,693.39,133,95,38
983,Anthony,Books,Academic,693.39,286,252,34
984,Marvin,Clothing,Shirt,995.13,491,327,164
985,Fred,InvalidCategory,Academic,951.53,446,255,191
986,Wanda,Toys,Educational,0.01,459,399,60
987,Marvin,Clothing,Shirt,995.13,376,265,111
988,Jamie,Books,Fiction,930.3,158,87,71
989,Anthony,Books,Academic,693.39,285,253,32
990,Wanda,Toys,Educational,26861.0,328,95,233
991,Angela,Toys,Action Figures,386.57,133,74,59
992,Katie,Books,Non-fiction,99999.99,491,448,43
993,Justin,Electronics,Headphones,660.05,375,295,80
994,Marvin,Clothing,Shirt,0.01,367,356,11
995,Cynthia,Electronics,Headphones,InvalidPrice,53,15,38
996,Angela,InvalidCategory,Action Figures,386.57,55,19,36
997,Elizabeth,Clothing,Shirt,840.19,52,2,50
998,NonExistentProduct,Clothing,Shirt,840.19,329,50,279
999,Kristine,Electronics,Headphones,228.82,482,19,463
1000,Marvin,Clothing,Shirt,995.13,321,157,164
1001,Shawn,Electronics,Headphones,46109.0,137,21,116
1002,Nathaniel,Electronics,Camera,652.35,67,27,40
1003,Shannon,Home & Garden,Gardening Tools,0.01,431,222,209
1004,Angela,Toys,Action Figures,InvalidPrice,399,45,354
1005,Shannon,Home & Garden,Gardening Tools,99999.99,474,222,252
1006,NonExistentProduct,Electronics,Headphones,872.85,333,208,125
1007,Shawn,Electronics,Headphones,46109.0,424,162,262
1008,Tammy,Home & Garden,Furniture,431.82,122,60,62
1009,Cynthia,Electronics,Headphones,872.85,230,175,55
1010,Fred,Books,Academic,951.53,146,47,99
1011,Angela,Toys,Action Figures,386.57,121,110,11
1012,Michael,Toys,Dolls,46.23,317,94,223
1013,Martha,Books,Fiction,0.01,157,128,29
1014,Kristine,Electronics,Headphones,228.82,91,71,20
1015,Jamie,Books,Fiction,930.3,471,74,397
1016,Anthony,Books,Academic,693.39,241,110,131
1017,NonExistentProduct,Books,Fiction,433.1,257,218,39
1018,Pamela,Electronics,Headphones,651.11,352,337,15
1019,Amy,Home & Garden,Decor,364.01,134,30,104
1020,Jamie,Books,Fiction,930.3,60,42,18
1021,Katie,Books,Non-fiction,642.11,269,32,237
1022,Tammy,Home & Garden,Furniture,431.82,304,181,123
1023,Wanda,Toys,Educational,268.61,91,40,51
1024,Angela,InvalidCategory,Action Figures,386.57,167,26,141
1025,Shannon,InvalidCategory,Gardening Tools,68.01,89,27,62
1026,Jamie,Books,Fiction,0.01,50,30,20
1027,Wanda,Toys,Educational,268.61,150,62,88
1028,Angela,Toys,Action Figures,InvalidPrice,170,107,63
1029,Robert,Electronics,Mobile,84743.0,336,146,190
1030,Angela,Toys,Action Figures,InvalidPrice,453,369,84
1031,NonExistentProduct,Toys,Dolls,46.23,399,47,352
1032,NonExistentProduct,Electronics,Mobile,847.43,407,77,330
1033,NonExistentProduct,Home & Garden,Furniture,431.82,323,267,56
1034,Anthony,Books,Academic,693.39,109,4,105
1035,Wanda,Toys,Educational,InvalidPrice,253,103,150
1036,NonExistentProduct,Home & Garden,Gardening Tools,68.01,481,128,353
1037,Amy,InvalidCategory,Decor,364.01,380,377,3
1038,Anthony,Books,Academic,693.39,207,143,64
1039,Justin,Electronics,Headphones,99999.99,68,19,49
1040,Marvin,Clothing,Shirt,0.01,337,192,145
1041,Jamie,Books,Fiction,93030.0,402,65,337
1042,Cynthia,Electronics,Headphones,872.85,270,100,170
1043,Cynthia,Electronics,Headphones,872.85,425,341,84
1044,Kristine,Electronics,Headphones,0.01,492,167,325
1045,Michael,Toys,Dolls,46.23,72,54,18
1046,Martha,Books,Fiction,433.1,106,62,44
1047,Amy,Home & Garden,Decor,364.01,65,51,14
1048,Kristine,Electronics,Headphones,228.82,188,92,96
1049,Amy,Home & Garden,Decor,36401.0,401,278,123
1050,Wanda,Toys,Educational,268.61,473,429,44
1051,Cynthia,Electronics,Headphones,872.85,370,176,194
1052,Wanda,Toys,Educational,268.61,348,64,284
1053,Cynthia,Electronics,Headphones,87285.0,215,133,82
1054,Anthony,Books,Academic,693.39,295,150,145
1055,Anthony,Books,Academic,0.01,86,76,10
1056,Katie,Books,Non-fiction,642.11,462,431,31
1057,Wanda,Toys,Educational,268.61,188,160,28
1058,Katie,Books,Non-fiction,642.11,223,48,175
1059,Fred,Books,Academic,InvalidPrice,75,33,42
1060,Shannon,Home & Garden,Gardening Tools,6801.000000000001,243,41,202
1061,Kristine,Electronics,Headphones,99999.99,232,64,168
1062,Angela,Toys,Action Figures,386.57,298,283,15
1063,Angela,InvalidCategory,Action Figures,38657.0,194,183,11
1064,Cynthia,Electronics,Headphones,87285.0,339,164,175
1065,Michael,Toys,Dolls,46.23,441,12,429
1066,Kristine,InvalidCategory,Headphones,228.82,112,45,67
1067,Michael,Toys,Dolls,4623.0,422,211,211
1068,Katie,Books,Non-fiction,642.11,140,19,121
1069,Pamela,Electronics,Headphones,651.11,239,63,176
1070,Shawn,Electronics,Headphones,46109.0,287,272,15
1071,Robert,Electronics,Mobile,847.43,145,89,56
1072,Marvin,InvalidCategory,Shirt,995.13,137,18,119
1073,Pamela,Electronics,Headphones,651.11,495,335,160
1074,Anthony,Books,Academic,693.39,132,105,27
1075,Kristine,Electronics,Headphones,228.82,225,214,11
1076,Robert,Electronics,Mobile,847.43,500,116,384
1077,Shannon,Home & Garden,Gardening Tools,InvalidPrice,472,11,461
1078,Jamie,Books,Fiction,0.01,230,21,209
1079,Cynthia,Electronics,Headphones,InvalidPrice,258,107,151
1080,Justin,Electronics,Headphones,660.05,307,306,1
1081,Fred,InvalidCategory,Academic,InvalidPrice,210,198,12
1082,Marvin,Clothing,Shirt,995.13,486,221,265
1083,Marvin,Clothing,Shirt,InvalidPrice,101,86,15
1084,Kristine,Electronics,Headphones,99999.99,390,374,16
1085,Fred,Books,Academic,0.01,75,24,51
1086,Robert,Electronics,Mobile,99999.99,232,189,43
1087,Elizabeth,Clothing,Shirt,840.19,404,80,324
1088,Michael,Toys,Dolls,46.23,184,72,112
1089,Nathaniel,Electronics,Camera,65235.0,373,199,174
1090,Amy,Home & Garden,Decor,36401.0,391,100,291
1091,Pamela,Electronics,Headphones,InvalidPrice,145,63,82
1092,Tammy,Home & Garden,Furniture,431.82,430,324,106
1093,Robert,Electronics,Mobile,847.43,297,155,142
1094,Jamie,InvalidCategory,Fiction,0.01,422,73,349
1095,Shannon,Home & Garden,Gardening Tools,InvalidPrice,116,64,52
1096,Jamie,Books,Fiction,930.3,342,227,115
1097,Anthony,Books,Academic,0.01,387,386,1
1098,Angela,Toys,Action Figures,386.57,426,289,137
1099,Amy,Home & Garden,Decor,364.01,216,135,81
1100,Wanda,Toys,Educational,268.61,141,15,126
1101,Martha,Books,Fiction,433.1,287,30,257
1102,Justin,Electronics,Headphones,660.05,91,80,11
1103,Michael,Toys,Dolls,46.23,212,45,167
1104,Amy,InvalidCategory,Decor,364.01,382,58,324
1105,Kristine,Electronics,Headphones,228.82,127,107,20
1106,NonExistentProduct,Electronics,Headphones,461.09,227,120,107
1107,Tammy,Home & Garden,Furniture,99999.99,97,28,69
1108,Angela,Toys,Action Figures,386.57,96,39,57
1109,Pamela,Electronics,Headphones,99999.99,221,217,4
1110,Angela,Toys,Action Figures,386.57,460,171,289
1111,Wanda,Toys,Educational,268.61,405,314,91
1112,Kristine,Electronics,Headphones,0.01,322,106,216
1113,Kristine,Electronics,Headphones,228.82,324,173,151
1114,NonExistentProduct,Clothing,Shirt,840.19,307,90,217
1115,Anthony,Books,Academic,InvalidPrice,407,330,77
1116,NonExistentProduct,Electronics,Headphones,99999.99,236,76,160
1117,Nathaniel,Electronics,Camera,652.35,369,54,315
1118,Robert,Electronics,Mobile,0.01,290,241,49
1119,Shannon,Home & Garden,Gardening Tools,68.01,74,40,34
1120,Kristine,InvalidCategory,Headphones,228.82,147,133,14
1121,Elizabeth,Clothing,Shirt,840.19,139,45,94
1122,Kristine,Electronics,Headphones,228.82,146,40,106
1123,Kristine,Electronics,Headphones,InvalidPrice,243,124,119
1124,Martha,Books,Fiction,433.1,464,115,349
1125,Anthony,Books,Academic,693.39,61,44,17
1126,Fred,Books,Academic,951.53,157,149,8
1127,Kristine,Electronics,Headphones,InvalidPrice,203,44,159
1128,Martha,Books,Fiction,InvalidPrice,443,104,339
1129,Kristine,Electronics,Headphones,228.82,174,74,100
1130,NonExistentProduct,Electronics,Headphones,461.09,322,24,298
1131,Robert,Electronics,Mobile,InvalidPrice,203,37,166
1132,Elizabeth,Clothing,Shirt,840.19,234,5,229
1133,Robert,Electronics,Mobile,InvalidPrice,51,17,34
1134,Nathaniel,Electronics,Camera,652.35,351,194,157
1135,Amy,Home & Garden,Decor,364.01,187,36,151
1136,Kristine,Electronics,Headphones,22882.0,208,21,187
1137,Elizabeth,Clothing,Shirt,0.01,147,77,70
1138,NonExistentProduct,Electronics,Mobile,847.43,134,128,6
1139,Robert,Electronics,Mobile,847.43,258,76,182
1140,Nathaniel,Electronics,Camera,652.35,100,84,16
1141,Tammy,Home & Garden,Furniture,99999.99,414,337,77
1142,Cynthia,Electronics,Headphones,872.85,470,98,372
1143,Michael,Toys,Dolls,46.23,281,186,95
1144,Michael,Toys,Dolls,46.23,165,118,47
1145,Shawn,Electronics,Headphones,461.09,205,23,182
1146,Elizabeth,Clothing,Shirt,840.19,74,60,14
1147,Amy,Home & Garden,Decor,364.01,120,13,107
1148,Robert,InvalidCategory,Mobile,InvalidPrice,70,38,32
1149,Angela,Toys,Action Figures,99999.99,391,314,77
1150,Justin,Electronics,Headphones,660.05,431,69,362
1151,Robert,Electronics,Mobile,847.43,284,233,51
1152,Martha,Books,Fiction,433.1,500,358,142
1153,Angela,Toys,Action Figures,386.57,411,209,202
1154,Kristine,Electronics,Headphones,228.82,263,206,57
1155,Shawn,Electronics,Headphones,461.09,64,33,31
1156,Wanda,Toys,Educational,268.61,164,78,86
1157,Jamie,Books,Fiction,93030.0,492,391,101
1158,Wanda,Toys,Educational,0.01,319,234,85
1159,Robert,Electronics,Mobile,847.43,337,9,328
1160,Tammy,InvalidCategory,Furniture,431.82,191,135,56
1161,Angela,Toys,Action Figures,386.57,232,175,57
1162,Elizabeth,Clothing,Shirt,840.19,105,50,55
1163,Pamela,Electronics,Headphones,99999.99,399,124,275
1164,Katie,Books,Non-fiction,642.11,439,244,195
1165,Kristine,Electronics,Headphones,228.82,98,69,29
1166,Elizabeth,Clothing,Shirt,840.19,489,416,73
1167,Pamela,Electronics,Headphones,651.11,453,85,368
1168,Shannon,Home & Garden,Gardening Tools,6801.000000000001,475,113,362
1169,Cynthia,Electronics,Headphones,872.85,293,258,35
1170,Katie,Books,Non-fiction,0.01,475,38,437
1171,Cynthia,Electronics,Headphones,872.85,104,66,38
1172,Kristine,Electronics,Headphones,228.82,484,225,259
1173,Elizabeth,Clothing,Shirt,840.19,232,195,37
1174,Shannon,Home & Garden,Gardening Tools,68.01,347,179,168
1175,Michael,Toys,Dolls,0.01,444,360,84
1176,Wanda,Toys,Educational,268.61,425,415,10
1177,Robert,Electronics,Mobile,847.43,299,242,57
1178,Elizabeth,Clothing,Shirt,840.19,193,99,94
1179,Anthony,Books,Academic,693.39,304,16,288
1180,Elizabeth,InvalidCategory,Shirt,840.19,385,82,303
1181,Amy,Home & Garden,Decor,36401.0,185,162,23
1182,Shawn,Electronics,Headphones,461.09,406,288,118
1183,Wanda,Toys,Educational,268.61,203,75,128
1184,NonExistentProduct,Electronics,Camera,652.35,198,68,130
1185,Martha,Books,Fiction,433.1,412,292,120
1186,Tammy,InvalidCategory,Furniture,431.82,125,27,98
1187,Shawn,Electronics,Headphones,461.09,119,106,13
1188,Cynthia,Electronics,Headphones,InvalidPrice,377,72,305
1189,Shawn,Electronics,Headphones,461.09,236,105,131
1190,Michael,Toys,Dolls,46.23,92,49,43
1191,Marvin,Clothing,Shirt,99999.99,454,16,438
1192,Wanda,Toys,Educational,268.61,247,187,60
1193,Tammy,Home & Garden,Furniture,99999.99,270,151,119
1194,Fred,Books,Academic,951.53,135,47,88
1195,Michael,Toys,Dolls,46.23,353,26,327
1196,Fred,Books,Academic,0.01,307,273,34
1197,Jamie,Books,Fiction,930.3,88,3,85
1198,Nathaniel,Electronics,Camera,0.01,278,217,61
1199,Elizabeth,Clothing,Shirt,840.19,95,60,35
1200,Nathaniel,Electronics,Camera,652.35,222,7,215
1201,Martha,Books,Fiction,99999.99,397,304,93
1202,Justin,Electronics,Headphones,660.05,72,57,15
1203,Amy,Home & Garden,Decor,364.01,413,358,55
1204,Nathaniel,Electronics,Camera,InvalidPrice,142,92,50
1205,Nathaniel,Electronics,Camera,652.35,204,200,4
1206,Angela,InvalidCategory,Action Figures,386.57,252,139,113
1207,Kristine,Electronics,Headphones,22882.0,93,12,81
1208,Martha,Books,Fiction,433.1,313,47,266
1209,Justin,Electronics,Headphones,660.05,288,247,41
1210,Marvin,Clothing,Shirt,995.13,54,34,20
1211,Cynthia,Electronics,Headphones,872.85,409,47,362
1212,Martha,Books,Fiction,433.1,498,334,164
1213,Katie,Books,Non-fiction,642.11,490,258,232
1214,Fred,Books,Academic,951.53,281,88,193
1215,Marvin,Clothing,Shirt,995.13,485,68,417
1216,Shannon,Home & Garden,Gardening Tools,68.01,77,16,61
1217,NonExistentProduct,Books,Academic,95153.0,54,21,33
1218,Wanda,Toys,Educational,99999.99,219,49,170
1219,NonExistentProduct,InvalidCategory,Shirt,84019.0,493,259,234
1220,Amy,Home & Garden,Decor,364.01,209,179,30
1221,Tammy,Home & Garden,Furniture,431.82,285,31,254
1222,Robert,Electronics,Mobile,847.43,339,102,237
1223,Katie,Books,Non-fiction,64211.0,337,56,281
1224,Fred,Books,Academic,InvalidPrice,407,251,156
1225,Marvin,InvalidCategory,Shirt,99513.0,494,385,109
1226,Wanda,Toys,Educational,26861.0,61,55,6
1227,Jamie,Books,Fiction,930.3,347,167,180
1228,Fred,Books,Academic,951.53,284,228,56
1229,Justin,Electronics,Headphones,660.05,246,233,13
1230,Shawn,Electronics,Headphones,461.09,109,57,52
1231,Martha,Books,Fiction,433.1,153,13,140
1232,Angela,Toys,Action Figures,99999.99,59,2,57
1233,NonExistentProduct,Home & Garden,Decor,364.01,481,56,425
1234,Cynthia,InvalidCategory,Headphones,872.85,85,27,58
1235,Shannon,Home & Garden,Gardening Tools,68.01,449,42,407
1236,NonExistentProduct,Books,Non-fiction,642.11,339,164,175
1237,Anthony,Books,Academic,693.39,300,284,16
1238,Angela,Toys,Action Figures,386.57,111,38,73
1239,Fred,InvalidCategory,Academic,951.53,389,330,59
1240,Pamela,Electronics,Headphones,651.11,197,111,86
1241,Justin,Electronics,Headphones,660.05,113,78,35
1242,Amy,Home & Garden,Decor,InvalidPrice,89,61,28
1243,Robert,Electronics,Mobile,InvalidPrice,496,494,2
1244,Amy,Home & Garden,Decor,99999.99,168,97,71
1245,Wanda,Toys,Educational,268.61,318,126,192
1246,Angela,Toys,Action Figures,386.57,411,401,10
1247,Shannon,Home & Garden,Gardening Tools,0.01,192,103,89
1248,Amy,Home & Garden,Decor,36401.0,170,62,108
1249,Angela,Toys,Action Figures,386.57,133,7,126
1250,Nathaniel,Electronics,Camera,652.35,427,361,66
1251,Cynthia,Electronics,Headphones,872.85,407,93,314
1252,Jamie,Books,Fiction,930.3,469,63,406
1253,Shannon,InvalidCategory,Gardening Tools,68.01,87,1,86
1254,Marvin,Clothing,Shirt,0.01,203,14,189
1255,Michael,Toys,Dolls,46.23,461,162,299
1256,Angela,Toys,Action Figures,386.57,177,138,39
1257,Angela,Toys,Action Figures,386.57,317,23,294
1258,Anthony,Books,Academic,693.39,391,171,220
1259,NonExistentProduct,Toys,Action Figures,386.57,270,230,40
1260,Pamela,Electronics,Headphones,65111.0,311,243,68
1261,Kristine,Electronics,Headphones,228.82,441,246,195
1262,Pamela,Electronics,Headphones,651.11,131,121,10
1263,Fred,InvalidCategory,Academic,951.53,307,64,243
1264,Anthony,Books,Academic,InvalidPrice,429,310,119
1265,Pamela,InvalidCategory,Headphones,0.01,135,81,54
1266,Marvin,Clothing,Shirt,99513.0,141,61,80
1267,Shawn,InvalidCategory,Headphones,InvalidPrice,73,52,21
1268,Martha,Books,Fiction,433.1,89,27,62
1269,Cynthia,InvalidCategory,Headphones,872.85,307,299,8
1270,Pamela,Electronics,Headphones,99999.99,492,378,114
1271,Michael,Toys,Dolls,46.23,264,123,141
1272,Michael,Toys,Dolls,46.23,330,231,99
1273,Shannon,Home & Garden,Gardening Tools,68.01,236,135,101
1274,Martha,Books,Fiction,0.01,349,45,304
1275,Angela,Toys,Action Figures,99999.99,307,126,181
1276,Cynthia,Electronics,Headphones,872.85,116,38,78
1277,Shawn,Electronics,Headphones,461.09,139,94,45
1278,Amy,InvalidCategory,Decor,364.01,304,269,35
1279,Pamela,Electronics,Headphones,651.11,457,25,432
1280,Michael,Toys,Dolls,46.23,423,201,222
1281,Martha,InvalidCategory,Fiction,433.1,318,130,188
1282,Michael,Toys,Dolls,46.23,472,6,466
1283,Angela,InvalidCategory,Action Figures,386.57,326,47,279
1284,Shannon,Home & Garden,Gardening Tools,68.01,474,413,61
1285,Amy,Home & Garden,Decor,0.01,474,317,157
1286,Katie,InvalidCategory,Non-fiction,642.11,497,248,249
1287,Justin,InvalidCategory,Headphones,660.05,483,414,69
1288,Wanda,Toys,Educational,InvalidPrice,318,2,316
1289,Fred,Books,Academic,951.53,121,21,100
1290,Shawn,Electronics,Headphones,InvalidPrice,473,345,128
1291,Shannon,Home & Garden,Gardening Tools,68.01,255,149,106
1292,Tammy,Home & Garden,Furniture,InvalidPrice,105,9,96
1293,Robert,Electronics,Mobile,847.43,492,344,148
1294,Elizabeth,Clothing,Shirt,840.19,374,250,124
1295,Robert,Electronics,Mobile,84743.0,159,29,130
1296,Nathaniel,Electronics,Camera,InvalidPrice,137,28,109
1297,NonExistentProduct,Home & Garden,Furniture,431.82,455,204,251
1298,Wanda,Toys,Educational,268.61,465,270,195
1299,Kristine,Electronics,Headphones,228.82,114,102,12
1300,Shannon,Home & Garden,Gardening Tools,68.01,384,117,267
1301,NonExistentProduct,Home & Garden,Furniture,431.82,494,483,11
1302,Shawn,Electronics,Headphones,461.09,146,74,72
1303,Cynthia,Electronics,Headphones,872.85,490,313,177
1304,Elizabeth,Clothing,Shirt,840.19,213,211,2
1305,Cynthia,Electronics,Headphones,872.85,417,61,356
1306,Fred,Books,Academic,951.53,477,401,76
1307,Elizabeth,Clothing,Shirt,840.19,258,139,119
1308,Nathaniel,Electronics,Camera,652.35,406,48,358
1309,NonExistentProduct,Home & Garden,Furniture,431.82,310,7,303
1310,Wanda,Toys,Educational,268.61,398,159,239
1311,Amy,Home & Garden,Decor,364.01,160,72,88
1312,NonExistentProduct,Books,Fiction,930.3,484,167,317
1313,Kristine,Electronics,Headphones,22882.0,430,384,46
1314,Angela,Toys,Action Figures,386.57,179,57,122
1315,Kristine,Electronics,Headphones,228.82,106,76,30
1316,Kristine,Electronics,Headphones,228.82,332,238,94
1317,Katie,Books,Non-fiction,642.11,190,172,18
1318,Nathaniel,Electronics,Camera,65235.0,290,98,192
1319,Robert,Electronics,Mobile,847.43,281,269,12
1320,NonExistentProduct,Electronics,Headphones,InvalidPrice,364,88,276
1321,Wanda,Toys,Educational,26861.0,340,40,300
1322,NonExistentProduct,Books,Non-fiction,642.11,107,26,81
1323,Shawn,Electronics,Headphones,461.09,323,323,0
1324,Wanda,Toys,Educational,268.61,250,62,188
1325,Fred,Books,Academic,951.53,323,288,35
1326,Anthony,Books,Academic,693.39,238,15,223
1327,Amy,InvalidCategory,Decor,364.01,323,289,34
1328,Cynthia,Electronics,Headphones,0.01,241,210,31
1329,Jamie,Books,Fiction,930.3,385,29,356
1330,Amy,Home & Garden,Decor,InvalidPrice,53,1,52
1331,Amy,Home & Garden,Decor,364.01,132,108,24
1332,Robert,Electronics,Mobile,0.01,429,337,92
1333,Cynthia,Electronics,Headphones,872.85,178,151,27
1334,Wanda,Toys,Educational,26861.0,221,77,144
1335,NonExistentProduct,Electronics,Headphones,660.05,347,32,315
1336,Anthony,Books,Academic,693.39,271,124,147
1337,Elizabeth,Clothing,Shirt,840.19,98,22,76
1338,Angela,InvalidCategory,Action Figures,InvalidPrice,289,123,166
1339,Justin,Electronics,Headphones,660.05,111,39,72
1340,Kristine,Electronics,Headphones,228.82,248,215,33
1341,Michael,Toys,Dolls,46.23,77,20,57
1342,Cynthia,Electronics,Headphones,872.85,496,282,214
1343,Michael,Toys,Dolls,46.23,232,80,152
1344,Tammy,InvalidCategory,Furniture,431.82,124,46,78
1345,Shannon,Home & Garden,Gardening Tools,68.01,373,139,234
1346,Cynthia,Electronics,Headphones,872.85,105,90,15
1347,Robert,Electronics,Mobile,847.43,272,206,66
1348,Katie,Books,Non-fiction,642.11,214,33,181
1349,Martha,Books,Fiction,433.1,298,48,250
1350,Katie,Books,Non-fiction,InvalidPrice,96,87,9
1351,Katie,Books,Non-fiction,642.11,193,148,45
1352,Marvin,Clothing,Shirt,99513.0,222,65,157
1353,NonExistentProduct,Clothing,Shirt,995.13,153,87,66
1354,Michael,Toys,Dolls,4623.0,281,116,165
1355,Elizabeth,Clothing,Shirt,840.19,435,429,6
1356,Shawn,Electronics,Headphones,461.09,111,88,23
1357,Fred,Books,Academic,951.53,230,190,40
1358,Cynthia,Electronics,Headphones,872.85,274,24,250
1359,Pamela,Electronics,Headphones,651.11,383,339,44
1360,Nathaniel,Electronics,Camera,652.35,262,120,142
1361,Robert,Electronics,Mobile,847.43,260,2,258
1362,Angela,Toys,Action Figures,38657.0,215,158,57
1363,Shawn,Electronics,Headphones,0.01,336,169,167
1364,Kristine,Electronics,Headphones,228.82,231,71,160
1365,Anthony,Books,Academic,InvalidPrice,283,13,270
1366,Tammy,Home & Garden,Furniture,431.82,350,338,12
1367,Martha,InvalidCategory,Fiction,433.1,341,273,68
1368,Martha,Books,Fiction,433.1,347,112,235
1369,Wanda,Toys,Educational,268.61,269,214,55
1370,Shawn,Electronics,Headphones,461.09,267,215,52
1371,Tammy,Home & Garden,Furniture,99999.99,191,176,15
1372,Tammy,Home & Garden,Furniture,InvalidPrice,447,175,272
1373,Amy,Home & Garden,Decor,364.01,438,156,282
1374,Nathaniel,Electronics,Camera,652.35,118,65,53
1375,Shannon,Home & Garden,Gardening Tools,6801.000000000001,248,243,5
1376,Shannon,Home & Garden,Gardening Tools,68.01,111,6,105
1377,Marvin,Clothing,Shirt,995.13,111,101,10
1378,Shannon,Home & Garden,Gardening Tools,68.01,310,84,226
1379,NonExistentProduct,Electronics,Camera,652.35,412,225,187
1380,Justin,Electronics,Headphones,0.01,281,152,129
1381,Kristine,InvalidCategory,Headphones,228.82,458,101,357
1382,Jamie,Books,Fiction,93030.0,419,261,158
1383,NonExistentProduct,Clothing,Shirt,995.13,359,193,166
1384,Robert,Electronics,Mobile,847.43,153,134,19
1385,Pamela,Electronics,Headphones,651.11,391,66,325
1386,Kristine,Electronics,Headphones,228.82,319,286,33
1387,Marvin,Clothing,Shirt,InvalidPrice,166,16,150
1388,Fred,InvalidCategory,Academic,951.53,453,109,344
1389,Tammy,Home & Garden,Furniture,InvalidPrice,143,10,133
1390,NonExistentProduct,InvalidCategory,Non-fiction,642.11,326,183,143
1391,Nathaniel,Electronics,Camera,652.35,493,493,0
1392,Anthony,Books,Academic,InvalidPrice,422,111,311
1393,NonExistentProduct,Books,Academic,951.53,433,355,78
1394,Tammy,Home & Garden,Furniture,InvalidPrice,198,63,135
1395,Angela,Toys,Action Figures,386.57,312,219,93
1396,Fred,Books,Academic,951.53,441,3,438
1397,Michael,InvalidCategory,Dolls,4623.0,100,67,33
1398,Jamie,Books,Fiction,930.3,491,452,39
1399,Nathaniel,Electronics,Camera,0.01,472,175,297
1400,Fred,Books,Academic,951.53,381,301,80
1401,Michael,Toys,Dolls,46.23,200,24,176
1402,Katie,Books,Non-fiction,642.11,123,96,27
1403,Jamie,Books,Fiction,930.3,238,82,156
1404,Nathaniel,Electronics,Camera,652.35,248,41,207
1405,NonExistentProduct,Toys,Action Figures,386.57,454,134,320
1406,Pamela,InvalidCategory,Headphones,651.11,417,111,306
1407,Robert,Electronics,Mobile,847.43,117,60,57
1408,Angela,Toys,Action Figures,386.57,447,155,292
1409,Shawn,Electronics,Headphones,461.09,394,302,92
1410,Katie,Books,Non-fiction,642.11,480,133,347
1411,Wanda,InvalidCategory,Educational,99999.99,160,115,45
1412,Jamie,Books,Fiction,930.3,484,466,18
1413,Marvin,Clothing,Shirt,995.13,378,272,106
1414,Martha,Books,Fiction,43310.0,301,243,58
1415,NonExistentProduct,Books,Academic,951.53,230,31,199
1416,Marvin,InvalidCategory,Shirt,995.13,500,111,389
1417,Shawn,Electronics,Headphones,InvalidPrice,301,229,72
1418,Martha,Books,Fiction,0.01,464,388,76
1419,Elizabeth,Clothing,Shirt,840.19,306,150,156
1420,Anthony,Books,Academic,693.39,168,148,20
1421,Martha,Books,Fiction,433.1,379,171,208
1422,Jamie,Books,Fiction,930.3,197,57,140
1423,Martha,Books,Fiction,InvalidPrice,113,66,47
1424,Wanda,Toys,Educational,268.61,90,6,84
1425,Jamie,Books,Fiction,93030.0,121,52,69
1426,Nathaniel,Electronics,Camera,InvalidPrice,175,85,90
1427,Wanda,Toys,Educational,268.61,167,126,41
1428,Michael,InvalidCategory,Dolls,InvalidPrice,343,153,190
1429,Elizabeth,Clothing,Shirt,84019.0,395,98,297
1430,NonExistentProduct,Electronics,Headphones,660.05,290,179,111
1431,Anthony,Books,Academic,693.39,394,191,203
1432,Katie,Books,Non-fiction,642.11,325,15,310
1433,Shawn,Electronics,Headphones,InvalidPrice,469,370,99
1434,Kristine,Electronics,Headphones,228.82,252,240,12
1435,Cynthia,Electronics,Headphones,872.85,399,36,363
1436,Michael,Toys,Dolls,46.23,88,39,49
1437,Angela,Toys,Action Figures,386.57,180,100,80
1438,Elizabeth,Clothing,Shirt,84019.0,167,50,117
1439,Fred,Books,Academic,951.53,260,245,15
1440,Fred,Books,Academic,951.53,231,135,96
1441,Elizabeth,Clothing,Shirt,840.19,159,118,41
1442,Shawn,Electronics,Headphones,99999.99,128,123,5
1443,Nathaniel,Electronics,Camera,652.35,405,183,222
1444,Marvin,Clothing,Shirt,995.13,288,215,73
1445,Robert,Electronics,Mobile,847.43,176,67,109
1446,Martha,Books,Fiction,433.1,403,191,212
1447,Amy,Home & Garden,Decor,364.01,229,13,216
1448,Justin,Electronics,Headphones,660.05,452,242,210
1449,Wanda,Toys,Educational,268.61,397,183,214
1450,Michael,Toys,Dolls,InvalidPrice,297,146,151
1451,Shannon,Home & Garden,Gardening Tools,68.01,131,5,126
1452,Wanda,InvalidCategory,Educational,268.61,259,140,119
1453,Justin,Electronics,Headphones,66005.0,322,132,190
1454,NonExistentProduct,Books,Fiction,930.3,223,202,21
1455,Robert,Electronics,Mobile,847.43,58,28,30
1456,Michael,Toys,Dolls,InvalidPrice,203,99,104
1457,Cynthia,Electronics,Headphones,872.85,441,97,344
1458,Nathaniel,Electronics,Camera,652.35,454,243,211
1459,Marvin,Clothing,Shirt,995.13,279,240,39
1460,Tammy,Home & Garden,Furniture,431.82,170,64,106
1461,Marvin,Clothing,Shirt,InvalidPrice,356,80,276
1462,Amy,Home & Garden,Decor,364.01,61,44,17
1463,Jamie,Books,Fiction,930.3,496,330,166
1464,Elizabeth,Clothing,Shirt,840.19,268,123,145
1465,Marvin,Clothing,Shirt,99513.0,113,75,38
1466,Katie,Books,Non-fiction,642.11,409,196,213
1467,NonExistentProduct,Books,Academic,693.39,427,95,332
1468,Amy,Home & Garden,Decor,364.01,149,143,6
1469,Cynthia,Electronics,Headphones,872.85,86,15,71
1470,Wanda,Toys,Educational,268.61,229,135,94
1471,Elizabeth,Clothing,Shirt,99999.99,288,128,160
1472,Amy,Home & Garden,Decor,364.01,145,51,94
1473,Robert,Electronics,Mobile,847.43,346,45,301
1474,Katie,Books,Non-fiction,642.11,432,64,368
1475,Elizabeth,Clothing,Shirt,840.19,151,97,54
1476,Katie,Books,Non-fiction,642.11,385,77,308
1477,Anthony,Books,Academic,693.39,266,58,208
1478,Robert,Electronics,Mobile,847.43,427,98,329
1479,Marvin,InvalidCategory,Shirt,99999.99,200,150,50
1480,NonExistentProduct,Books,Fiction,930.3,107,78,29
1481,Amy,Home & Garden,Decor,InvalidPrice,365,15,350
1482,NonExistentProduct,InvalidCategory,Shirt,840.19,232,65,167
1483,Martha,Books,Fiction,433.1,74,66,8
1484,NonExistentProduct,Toys,Educational,268.61,210,170,40
1485,Martha,Books,Fiction,433.1,288,54,234
1486,Kristine,Electronics,Headphones,228.82,158,130,28
1487,NonExistentProduct,Electronics,Headphones,228.82,279,252,27
1488,NonExistentProduct,Books,Academic,951.53,51,45,6
1489,Amy,Home & Garden,Decor,0.01,222,66,156
1490,Shawn,Electronics,Headphones,461.09,161,132,29
1491,Robert,Electronics,Mobile,847.43,404,128,276
1492,Jamie,Books,Fiction,930.3,136,38,98
1493,NonExistentProduct,InvalidCategory,Dolls,99999.99,357,150,207
1494,NonExistentProduct,Electronics,Headphones,872.85,332,99,233
1495,Fred,Books,Academic,95153.0,447,441,6
1496,Fred,InvalidCategory,Academic,951.53,300,3,297
1497,Martha,Books,Fiction,433.1,57,5,52
1498,Shawn,Electronics,Headphones,461.09,260,248,12
1499,Wanda,InvalidCategory,Educational,268.61,488,198,290
1500,Martha,Books,Fiction,433.1,226,120,106
1501,NonExistentProduct,Toys,Educational,268.61,336,160,176
1502,Wanda,Toys,Educational,26861.0,436,427,9
1503,Fred,Books,Academic,951.53,89,89,0
1504,Michael,Toys,Dolls,0.01,236,132,104
1505,Robert,Electronics,Mobile,847.43,234,185,49
1506,Amy,Home & Garden,Decor,364.01,453,380,73
1507,NonExistentProduct,Home & Garden,Furniture,43182.0,436,317,119
1508,Robert,Electronics,Mobile,847.43,289,68,221
1509,Marvin,Clothing,Shirt,995.13,214,55,159
1510,Martha,Books,Fiction,433.1,281,102,179
1511,Justin,Electronics,Headphones,660.05,483,450,33
1512,Jamie,Books,Fiction,930.3,447,5,442
1513,Amy,Home & Garden,Decor,364.01,180,115,65
1514,Pamela,Electronics,Headphones,651.11,118,65,53
1515,NonExistentProduct,Toys,Dolls,46.23,85,37,48
1516,NonExistentProduct,Electronics,Mobile,847.43,310,177,133
1517,Amy,Home & Garden,Decor,364.01,214,199,15
1518,Tammy,Home & Garden,Furniture,InvalidPrice,225,206,19
1519,Anthony,Books,Academic,693.39,89,64,25
1520,Kristine,Electronics,Headphones,228.82,398,97,301
1521,NonExistentProduct,Books,Non-fiction,642.11,185,169,16
1522,Fred,Books,Academic,951.53,371,36,335
1523,Shawn,Electronics,Headphones,461.09,98,20,78
1524,NonExistentProduct,Toys,Dolls,46.23,75,60,15
1525,Katie,Books,Non-fiction,642.11,143,50,93
1526,Cynthia,Electronics,Headphones,872.85,275,202,73
1527,Justin,InvalidCategory,Headphones,660.05,322,187,135
1528,Robert,Electronics,Mobile,847.43,349,187,162
1529,Cynthia,InvalidCategory,Headphones,87285.0,299,36,263
1530,Shannon,Home & Garden,Gardening Tools,InvalidPrice,347,223,124
1531,Elizabeth,InvalidCategory,Shirt,840.19,132,29,103
1532,Elizabeth,Clothing,Shirt,840.19,214,124,90
1533,Pamela,Electronics,Headphones,651.11,322,37,285
1534,Pamela,Electronics,Headphones,651.11,196,19,177
1535,Michael,InvalidCategory,Dolls,46.23,271,127,144
1536,Fred,Books,Academic,951.53,383,331,52
1537,Amy,Home & Garden,Decor,0.01,347,249,98
1538,Kristine,Electronics,Headphones,22882.0,455,105,350
1539,Martha,InvalidCategory,Fiction,433.1,402,340,62
1540,Fred,Books,Academic,99999.99,263,168,95
1541,Martha,Books,Fiction,InvalidPrice,115,32,83
1542,Elizabeth,Clothing,Shirt,99999.99,481,112,369
1543,Wanda,Toys,Educational,268.61,346,189,157
1544,Elizabeth,Clothing,Shirt,840.19,363,172,191
1545,Justin,Electronics,Headphones,660.05,69,32,37
1546,Nathaniel,Electronics,Camera,652.35,282,191,91
1547,NonExistentProduct,Toys,Educational,268.61,57,56,1
1548,Anthony,Books,Academic,693.39,106,62,44
1549,Marvin,Clothing,Shirt,995.13,369,191,178
1550,Jamie,InvalidCategory,Fiction,930.3,143,82,61
1551,Marvin,Clothing,Shirt,0.01,143,17,126
1552,Angela,Toys,Action Figures,38657.0,293,159,134
1553,Tammy,Home & Garden,Furniture,431.82,373,259,114
1554,Justin,Electronics,Headphones,660.05,238,160,78
1555,Nathaniel,Electronics,Camera,65235.0,59,46,13
1556,Elizabeth,Clothing,Shirt,840.19,117,20,97
1557,Shannon,Home & Garden,Gardening Tools,0.01,464,215,249
1558,Katie,Books,Non-fiction,99999.99,413,194,219
1559,Kristine,Electronics,Headphones,228.82,140,3,137
1560,Anthony,InvalidCategory,Academic,693.39,103,101,2
1561,Angela,Toys,Action Figures,386.57,174,155,19
1562,Shawn,InvalidCategory,Headphones,461.09,112,11,101
1563,Elizabeth,Clothing,Shirt,840.19,305,288,17
1564,Shannon,Home & Garden,Gardening Tools,68.01,436,40,396
1565,Angela,Toys,Action Figures,386.57,321,317,4
1566,NonExistentProduct,Toys,Educational,268.61,422,357,65
1567,Angela,Toys,Action Figures,386.57,71,36,35
1568,Pamela,Electronics,Headphones,651.11,479,83,396
1569,NonExistentProduct,InvalidCategory,Headphones,651.11,367,25,342
1570,Shannon,Home & Garden,Gardening Tools,68.01,377,222,155
1571,Marvin,Clothing,Shirt,995.13,135,17,118
1572,Marvin,Clothing,Shirt,995.13,341,11,330
1573,Angela,Toys,Action Figures,0.01,213,108,105
1574,Shannon,Home & Garden,Gardening Tools,0.01,80,38,42
1575,Tammy,Home & Garden,Furniture,431.82,143,103,40
1576,Nathaniel,InvalidCategory,Camera,InvalidPrice,268,243,25
1577,Katie,Books,Non-fiction,642.11,226,178,48
1578,Elizabeth,Clothing,Shirt,99999.99,79,35,44
1579,Marvin,Clothing,Shirt,99513.0,182,155,27
1580,Cynthia,Electronics,Headphones,872.85,388,222,166
1581,Elizabeth,Clothing,Shirt,840.19,496,458,38
1582,Fred,Books,Academic,951.53,259,254,5
1583,Nathaniel,Electronics,Camera,652.35,84,51,33
1584,Nathaniel,Electronics,Camera,652.35,357,292,65
1585,Shawn,Electronics,Headphones,461.09,319,64,255
1586,Shannon,Home & Garden,Gardening Tools,InvalidPrice,349,315,34
1587,Marvin,Clothing,Shirt,995.13,357,117,240
1588,Martha,Books,Fiction,433.1,207,150,57
1589,Nathaniel,Electronics,Camera,652.35,258,159,99
1590,Nathaniel,Electronics,Camera,InvalidPrice,431,303,128
1591,Shannon,Home & Garden,Gardening Tools,68.01,228,172,56
1592,Kristine,Electronics,Headphones,InvalidPrice,75,22,53
1593,Robert,InvalidCategory,Mobile,847.43,316,160,156
1594,Justin,InvalidCategory,Headphones,660.05,446,27,419
1595,NonExistentProduct,Electronics,Headphones,99999.99,86,19,67
1596,NonExistentProduct,InvalidCategory,Non-fiction,99999.99,60,34,26
1597,Amy,Home & Garden,Decor,364.01,273,163,110
1598,Justin,Electronics,Headphones,660.05,401,198,203
1599,Justin,Electronics,Headphones,660.05,330,190,140
1600,Robert,Electronics,Mobile,InvalidPrice,171,123,48
1601,Martha,Books,Fiction,433.1,322,14,308
1602,Katie,Books,Non-fiction,642.11,397,203,194
1603,Nathaniel,InvalidCategory,Camera,652.35,79,64,15
1604,Robert,Electronics,Mobile,InvalidPrice,415,77,338
1605,Shawn,Electronics,Headphones,InvalidPrice,100,87,13
1606,NonExistentProduct,InvalidCategory,Dolls,46.23,102,15,87
1607,Angela,Toys,Action Figures,386.57,336,36,300
1608,Katie,Books,Non-fiction,642.11,337,283,54
1609,Amy,Home & Garden,Decor,364.01,80,18,62
1610,Shawn,Electronics,Headphones,461.09,79,76,3
1611,Wanda,Toys,Educational,268.61,279,207,72
1612,Pamela,Electronics,Headphones,99999.99,150,61,89
1613,Wanda,InvalidCategory,Educational,268.61,60,20,40
1614,Robert,Electronics,Mobile,847.43,103,87,16
1615,Cynthia,InvalidCategory,Headphones,872.85,464,26,438
1616,Tammy,Home & Garden,Furniture,431.82,132,26,106
1617,Shawn,InvalidCategory,Headphones,461.09,327,6,321
1618,Shannon,Home & Garden,Gardening Tools,68.01,357,51,306
1619,Martha,Books,Fiction,99999.99,248,139,109
1620,Michael,Toys,Dolls,46.23,321,242,79
1621,Angela,InvalidCategory,Action Figures,InvalidPrice,112,16,96
1622,Anthony,Books,Academic,99999.99,88,20,68
1623,Justin,Electronics,Headphones,99999.99,127,125,2
1624,Amy,Home & Garden,Decor,364.01,489,169,320
1625,Michael,Toys,Dolls,46.23,90,24,66
1626,Marvin,Clothing,Shirt,995.13,432,234,198
1627,Shannon,Home & Garden,Gardening Tools,68.01,341,185,156
1628,Anthony,Books,Academic,693.39,295,172,123
1629,NonExistentProduct,Toys,Dolls,99999.99,308,165,143
1630,NonExistentProduct,Toys,Dolls,46.23,345,27,318
1631,Shawn,Electronics,Headphones,461.09,353,236,117
1632,Michael,Toys,Dolls,99999.99,411,404,7
1633,Nathaniel,Electronics,Camera,652.35,158,101,57
1634,Cynthia,Electronics,Headphones,872.85,352,183,169
1635,Jamie,Books,Fiction,930.3,219,123,96
1636,Nathaniel,Electronics,Camera,InvalidPrice,193,10,183
1637,Martha,Books,Fiction,43310.0,135,12,123
1638,Fred,Books,Academic,951.53,193,86,107
1639,Elizabeth,Clothing,Shirt,840.19,158,130,28
1640,Kristine,InvalidCategory,Headphones,228.82,424,229,195
1641,Shannon,Home & Garden,Gardening Tools,68.01,197,52,145
1642,Jamie,InvalidCategory,Fiction,930.3,445,87,358
1643,Katie,Books,Non-fiction,642.11,272,120,152
1644,Jamie,InvalidCategory,Fiction,930.3,88,73,15
1645,Katie,Books,Non-fiction,0.01,322,234,88
1646,Shawn,Electronics,Headphones,461.09,369,196,173
1647,Cynthia,Electronics,Headphones,872.85,366,14,352
1648,Marvin,InvalidCategory,Shirt,995.13,413,249,164
1649,NonExistentProduct,Home & Garden,Gardening Tools,68.01,84,49,35
1650,Michael,Toys,Dolls,46.23,348,244,104
1651,Michael,Toys,Dolls,46.23,205,118,87
1652,Cynthia,Electronics,Headphones,InvalidPrice,327,27,300
1653,Nathaniel,Electronics,Camera,652.35,407,362,45
1654,Tammy,Home & Garden,Furniture,431.82,228,186,42
1655,Amy,Home & Garden,Decor,36401.0,130,99,31
1656,Marvin,InvalidCategory,Shirt,995.13,354,108,246
1657,Justin,Electronics,Headphones,660.05,174,105,69
1658,Fred,Books,Academic,99999.99,341,305,36
1659,Fred,Books,Academic,951.53,196,81,115
1660,Marvin,Clothing,Shirt,995.13,414,278,136
1661,NonExistentProduct,InvalidCategory,Mobile,847.43,110,30,80
1662,Shawn,Electronics,Headphones,InvalidPrice,364,270,94
1663,Pamela,Electronics,Headphones,65111.0,456,147,309
1664,Tammy,Home & Garden,Furniture,431.82,57,46,11
1665,Pamela,Electronics,Headphones,65111.0,395,356,39
1666,Shawn,Electronics,Headphones,46109.0,258,141,117
1667,Shawn,Electronics,Headphones,461.09,454,385,69
1668,Angela,Toys,Action Figures,0.01,436,410,26
1669,Angela,Toys,Action Figures,386.57,206,125,81
1670,Pamela,Electronics,Headphones,651.11,111,37,74
1671,Marvin,Clothing,Shirt,995.13,197,109,88
1672,Shawn,Electronics,Headphones,461.09,479,13,466
1673,Tammy,Home & Garden,Furniture,431.82,275,275,0
1674,Cynthia,Electronics,Headphones,InvalidPrice,68,18,50
1675,Robert,Electronics,Mobile,84743.0,212,75,137
1676,Robert,Electronics,Mobile,84743.0,410,277,133
1677,Katie,Books,Non-fiction,642.11,435,288,147
1678,Pamela,Electronics,Headphones,651.11,355,225,130
1679,Robert,Electronics,Mobile,847.43,406,333,73
1680,Robert,Electronics,Mobile,847.43,165,137,28
1681,Angela,Toys,Action Figures,386.57,432,408,24
1682,Robert,InvalidCategory,Mobile,847.43,108,10,98
1683,Michael,Toys,Dolls,46.23,454,389,65
1684,Fred,Books,Academic,951.53,124,47,77
1685,Pamela,Electronics,Headphones,651.11,149,50,99
1686,Nathaniel,Electronics,Camera,652.35,99,77,22
1687,Elizabeth,Clothing,Shirt,840.19,310,281,29
1688,Wanda,Toys,Educational,0.01,347,293,54
1689,Shawn,Electronics,Headphones,461.09,294,148,146
1690,Shannon,Home & Garden,Gardening Tools,InvalidPrice,474,235,239
1691,Anthony,Books,Academic,693.39,313,151,162
1692,Amy,Home & Garden,Decor,364.01,79,60,19
1693,Martha,Books,Fiction,433.1,60,50,10
1694,Pamela,Electronics,Headphones,651.11,408,276,132
1695,Jamie,Books,Fiction,930.3,173,19,154
1696,NonExistentProduct,Electronics,Camera,InvalidPrice,337,73,264
1697,Michael,Toys,Dolls,46.23,236,216,20
1698,Shawn,Electronics,Headphones,461.09,196,107,89
1699,Amy,Home & Garden,Decor,InvalidPrice,480,463,17
1700,NonExistentProduct,Toys,Dolls,0.01,192,166,26
1701,Amy,Home & Garden,Decor,0.01,412,303,109
1702,Wanda,Toys,Educational,268.61,178,154,24
1703,Angela,Toys,Action Figures,386.57,447,27,420
1704,Jamie,Books,Fiction,99999.99,471,423,48
1705,Shawn,Electronics,Headphones,461.09,428,394,34
1706,Kristine,Electronics,Headphones,228.82,62,31,31
1707,Tammy,InvalidCategory,Furniture,431.82,229,202,27
1708,Katie,Books,Non-fiction,0.01,75,5,70
1709,Jamie,Books,Fiction,930.3,315,231,84
1710,Martha,Books,Fiction,433.1,405,395,10
1711,Fred,Books,Academic,951.53,286,107,179
1712,Kristine,Electronics,Headphones,228.82,126,57,69
1713,Shawn,Electronics,Headphones,461.09,270,241,29
1714,Shannon,Home & Garden,Gardening Tools,68.01,262,228,34
1715,Wanda,Toys,Educational,268.61,366,112,254
1716,Wanda,Toys,Educational,26861.0,145,35,110
1717,Marvin,Clothing,Shirt,995.13,342,294,48
1718,Pamela,Electronics,Headphones,651.11,202,59,143
1719,Shawn,Electronics,Headphones,461.09,343,84,259
1720,Robert,Electronics,Mobile,847.43,120,24,96
1721,Elizabeth,Clothing,Shirt,840.19,326,299,27
1722,Justin,Electronics,Headphones,99999.99,184,29,155
1723,Marvin,Clothing,Shirt,995.13,121,64,57
1724,Nathaniel,Electronics,Camera,InvalidPrice,395,302,93
1725,Michael,Toys,Dolls,InvalidPrice,490,66,424
1726,Cynthia,Electronics,Headphones,872.85,91,59,32
1727,Anthony,Books,Academic,69339.0,440,439,1
1728,Jamie,Books,Fiction,930.3,66,24,42
1729,Anthony,Books,Academic,693.39,354,241,113
1730,Shannon,Home & Garden,Gardening Tools,68.01,100,68,32
1731,Fred,Books,Academic,951.53,493,60,433
1732,Shannon,Home & Garden,Gardening Tools,0.01,381,176,205
1733,Marvin,Clothing,Shirt,995.13,232,52,180
1734,Anthony,Books,Academic,693.39,427,114,313
1735,Robert,Electronics,Mobile,84743.0,321,99,222
1736,Amy,InvalidCategory,Decor,36401.0,367,266,101
1737,Angela,Toys,Action Figures,386.57,54,18,36
1738,Cynthia,Electronics,Headphones,872.85,399,103,296
1739,Shawn,Electronics,Headphones,461.09,468,439,29
1740,Marvin,Clothing,Shirt,0.01,302,55,247
1741,Elizabeth,Clothing,Shirt,840.19,286,273,13
1742,Pamela,InvalidCategory,Headphones,65111.0,449,341,108
1743,Michael,Toys,Dolls,46.23,67,52,15
1744,Katie,Books,Non-fiction,642.11,92,33,59
1745,Jamie,Books,Fiction,99999.99,440,113,327
1746,Shannon,Home & Garden,Gardening Tools,68.01,484,152,332
1747,NonExistentProduct,InvalidCategory,Camera,InvalidPrice,441,289,152
1748,Shannon,Home & Garden,Gardening Tools,68.01,383,44,339
1749,Nathaniel,Electronics,Camera,652.35,289,187,102
1750,NonExistentProduct,Electronics,Headphones,99999.99,367,218,149
1751,NonExistentProduct,Electronics,Headphones,872.85,347,284,63
1752,NonExistentProduct,Toys,Educational,268.61,479,473,6
1753,Kristine,Electronics,Headphones,228.82,282,195,87
1754,Angela,Toys,Action Figures,386.57,349,220,129
1755,NonExistentProduct,Clothing,Shirt,840.19,477,403,74
1756,Cynthia,Electronics,Headphones,872.85,456,218,238
1757,Angela,Toys,Action Figures,386.57,122,121,1
1758,Kristine,Electronics,Headphones,228.82,394,58,336
1759,Anthony,Books,Academic,693.39,51,39,12
1760,Justin,Electronics,Headphones,660.05,361,73,288
1761,Shawn,Electronics,Headphones,461.09,150,107,43
1762,Cynthia,Electronics,Headphones,872.85,460,424,36
1763,Kristine,Electronics,Headphones,228.82,267,53,214
1764,Wanda,Toys,Educational,99999.99,346,203,143
1765,Robert,Electronics,Mobile,847.43,145,79,66
1766,Michael,Toys,Dolls,46.23,186,81,105
1767,Katie,Books,Non-fiction,642.11,105,69,36
1768,Nathaniel,Electronics,Camera,652.35,102,32,70
1769,Tammy,Home & Garden,Furniture,431.82,282,10,272
1770,Jamie,Books,Fiction,InvalidPrice,214,148,66
1771,Michael,Toys,Dolls,InvalidPrice,398,90,308
1772,Wanda,Toys,Educational,26861.0,302,210,92
1773,NonExistentProduct,Books,Fiction,433.1,150,59,91
1774,Martha,Books,Fiction,43310.0,312,263,49
1775,NonExistentProduct,Toys,Educational,0.01,431,23,408
1776,Marvin,Clothing,Shirt,995.13,268,75,193
1777,Wanda,Toys,Educational,268.61,274,211,63
1778,Wanda,Toys,Educational,268.61,51,24,27
1779,Martha,Books,Fiction,433.1,372,366,6
1780,Justin,Electronics,Headphones,660.05,296,292,4
1781,Angela,Toys,Action Figures,386.57,115,42,73
1782,Cynthia,Electronics,Headphones,872.85,181,128,53
1783,Kristine,InvalidCategory,Headphones,228.82,445,147,298
1784,Jamie,Books,Fiction,930.3,289,109,180
1785,Martha,Books,Fiction,433.1,410,118,292
1786,Pamela,Electronics,Headphones,0.01,226,85,141
1787,NonExistentProduct,Home & Garden,Furniture,431.82,169,165,4
1788,Justin,Electronics,Headphones,660.05,223,208,15
1789,NonExistentProduct,Clothing,Shirt,995.13,446,193,253
1790,Pamela,Electronics,Headphones,651.11,434,326,108
1791,Fred,Books,Academic,95153.0,429,19,410
1792,Jamie,Books,Fiction,930.3,278,274,4
1793,NonExistentProduct,Electronics,Headphones,228.82,253,85,168
1794,Pamela,Electronics,Headphones,651.11,50,2,48
1795,Fred,Books,Academic,InvalidPrice,152,145,7
1796,Shannon,Home & Garden,Gardening Tools,68.01,154,138,16
1797,Robert,Electronics,Mobile,847.43,481,284,197
1798,Angela,Toys,Action Figures,38657.0,247,223,24
1799,Tammy,InvalidCategory,Furniture,431.82,105,26,79
1800,Fred,Books,Academic,95153.0,368,8,360
1801,Jamie,Books,Fiction,930.3,341,2,339
1802,NonExistentProduct,Clothing,Shirt,840.19,197,123,74
1803,Jamie,Books,Fiction,930.3,228,94,134
1804,Shannon,Home & Garden,Gardening Tools,68.01,337,3,334
1805,Fred,Books,Academic,0.01,424,208,216
1806,Robert,Electronics,Mobile,847.43,177,156,21
1807,Marvin,Clothing,Shirt,995.13,400,148,252
1808,Robert,Electronics,Mobile,847.43,383,315,68
1809,Marvin,Clothing,Shirt,995.13,201,68,133
1810,NonExistentProduct,Books,Fiction,930.3,396,224,172
1811,Wanda,Toys,Educational,26861.0,500,386,114
1812,Elizabeth,Clothing,Shirt,99999.99,177,94,83
1813,Robert,InvalidCategory,Mobile,847.43,214,70,144
1814,Angela,Toys,Action Figures,386.57,219,86,133
1815,Shannon,Home & Garden,Gardening Tools,68.01,162,152,10
1816,Michael,Toys,Dolls,46.23,281,260,21
1817,Elizabeth,Clothing,Shirt,84019.0,181,51,130
1818,Michael,Toys,Dolls,46.23,160,13,147
1819,Tammy,Home & Garden,Furniture,43182.0,83,10,73
1820,Fred,Books,Academic,951.53,110,81,29
1821,Angela,Toys,Action Figures,38657.0,423,354,69
1822,Amy,InvalidCategory,Decor,364.01,205,88,117
1823,Cynthia,Electronics,Headphones,87285.0,139,75,64
1824,Nathaniel,Electronics,Camera,99999.99,216,17,199
1825,Pamela,InvalidCategory,Headphones,0.01,318,169,149
1826,Jamie,Books,Fiction,InvalidPrice,432,225,207
1827,Pamela,Electronics,Headphones,65111.0,235,173,62
1828,Marvin,Clothing,Shirt,995.13,109,84,25
1829,Shannon,Home & Garden,Gardening Tools,0.01,119,23,96
1830,Marvin,Clothing,Shirt,995.13,328,39,289
1831,Jamie,Books,Fiction,930.3,354,206,148
1832,Justin,Electronics,Headphones,660.05,417,316,101
1833,Martha,Books,Fiction,433.1,337,151,186
1834,Robert,Electronics,Mobile,847.43,291,172,119
1835,Cynthia,InvalidCategory,Headphones,872.85,496,44,452
1836,Shawn,Electronics,Headphones,461.09,395,336,59
1837,Marvin,Clothing,Shirt,InvalidPrice,122,42,80
1838,Wanda,Toys,Educational,268.61,499,383,116
1839,Anthony,Books,Academic,693.39,143,132,11
1840,Nathaniel,Electronics,Camera,99999.99,62,38,24
1841,Tammy,Home & Garden,Furniture,431.82,244,197,47
1842,Michael,Toys,Dolls,46.23,303,95,208
1843,Martha,Books,Fiction,433.1,265,77,188
1844,Cynthia,Electronics,Headphones,872.85,451,308,143
1845,Nathaniel,Electronics,Camera,652.35,496,466,30
1846,Tammy,Home & Garden,Furniture,431.82,110,31,79
1847,Katie,Books,Non-fiction,642.11,300,279,21
1848,Justin,InvalidCategory,Headphones,660.05,361,150,211
1849,Anthony,Books,Academic,693.39,112,43,69
1850,NonExistentProduct,Electronics,Headphones,228.82,74,72,2
1851,Tammy,Home & Garden,Furniture,431.82,320,299,21
1852,Cynthia,Electronics,Headphones,872.85,172,136,36
1853,Jamie,InvalidCategory,Fiction,930.3,366,316,50
1854,Amy,Home & Garden,Decor,364.01,162,73,89
1855,Nathaniel,InvalidCategory,Camera,652.35,121,60,61
1856,Katie,Books,Non-fiction,0.01,430,103,327
1857,NonExistentProduct,Electronics,Headphones,65111.0,158,87,71
1858,Martha,Books,Fiction,433.1,433,22,411
1859,Fred,Books,Academic,InvalidPrice,294,23,271
1860,Anthony,Books,Academic,693.39,495,332,163
1861,Anthony,Books,Academic,693.39,500,440,60
1862,NonExistentProduct,Electronics,Mobile,0.01,198,94,104
1863,Amy,Home & Garden,Decor,364.01,207,25,182
1864,Cynthia,Electronics,Headphones,0.01,167,57,110
1865,Angela,Toys,Action Figures,386.57,74,38,36
1866,Katie,Books,Non-fiction,642.11,200,17,183
1867,Anthony,Books,Academic,99999.99,73,28,45
1868,Katie,Books,Non-fiction,642.11,431,233,198
1869,Amy,Home & Garden,Decor,364.01,418,216,202
1870,Shannon,Home & Garden,Gardening Tools,68.01,473,133,340
1871,Pamela,Electronics,Headphones,651.11,403,298,105
1872,Cynthia,Electronics,Headphones,0.01,394,234,160
1873,Shawn,Electronics,Headphones,99999.99,379,299,80
1874,Anthony,Books,Academic,693.39,178,48,130
1875,Cynthia,Electronics,Headphones,872.85,133,39,94
1876,Elizabeth,Clothing,Shirt,840.19,407,274,133
1877,NonExistentProduct,Books,Academic,693.39,355,129,226
1878,NonExistentProduct,InvalidCategory,Fiction,930.3,302,202,100
1879,Kristine,Electronics,Headphones,228.82,497,252,245
1880,Amy,Home & Garden,Decor,0.01,187,185,2
1881,Justin,Electronics,Headphones,660.05,168,150,18
1882,Pamela,InvalidCategory,Headphones,651.11,337,211,126
1883,Amy,Home & Garden,Decor,36401.0,429,206,223
1884,Elizabeth,Clothing,Shirt,84019.0,366,162,204
1885,Marvin,Clothing,Shirt,995.13,101,85,16
1886,Shawn,Electronics,Headphones,461.09,209,177,32
1887,Shawn,Electronics,Headphones,461.09,412,396,16
1888,Michael,Toys,Dolls,46.23,302,148,154
1889,Katie,Books,Non-fiction,64211.0,482,332,150
1890,Wanda,InvalidCategory,Educational,268.61,256,91,165
1891,Pamela,Electronics,Headphones,651.11,441,367,74
1892,Amy,Home & Garden,Decor,364.01,172,124,48
1893,NonExistentProduct,Electronics,Headphones,651.11,324,56,268
1894,Marvin,Clothing,Shirt,995.13,89,89,0
1895,Tammy,Home & Garden,Furniture,431.82,299,105,194
1896,Martha,Books,Fiction,43310.0,446,60,386
1897,Justin,Electronics,Headphones,660.05,258,1,257
1898,Angela,Toys,Action Figures,386.57,182,66,116
1899,Kristine,InvalidCategory,Headphones,228.82,428,138,290
1900,Fred,Books,Academic,951.53,380,333,47
1901,Amy,Home & Garden,Decor,364.01,86,17,69
1902,Marvin,InvalidCategory,Shirt,995.13,190,93,97
1903,Elizabeth,InvalidCategory,Shirt,840.19,392,233,159
1904,Angela,Toys,Action Figures,386.57,271,175,96
1905,Wanda,Toys,Educational,268.61,132,118,14
1906,Wanda,Toys,Educational,268.61,176,29,147
1907,Cynthia,InvalidCategory,Headphones,872.85,187,34,153
1908,Nathaniel,Electronics,Camera,65235.0,97,96,1
1909,NonExistentProduct,Electronics,Headphones,InvalidPrice,89,8,81
1910,Amy,InvalidCategory,Decor,364.01,110,48,62
1911,Marvin,Clothing,Shirt,0.01,461,123,338
1912,Tammy,Home & Garden,Furniture,431.82,326,49,277
1913,Marvin,Clothing,Shirt,InvalidPrice,465,163,302
1914,Shannon,Home & Garden,Gardening Tools,6801.000000000001,311,273,38
1915,Fred,InvalidCategory,Academic,951.53,392,128,264
1916,Wanda,InvalidCategory,Educational,268.61,366,128,238
1917,Amy,Home & Garden,Decor,99999.99,187,159,28
1918,Angela,Toys,Action Figures,386.57,121,22,99
1919,Shannon,Home & Garden,Gardening Tools,6801.000000000001,292,60,232
1920,NonExistentProduct,Clothing,Shirt,995.13,385,79,306
1921,Tammy,Home & Garden,Furniture,431.82,483,402,81
1922,Kristine,Electronics,Headphones,228.82,271,33,238
1923,Anthony,Books,Academic,693.39,290,71,219
1924,Kristine,Electronics,Headphones,228.82,280,259,21
1925,Michael,Toys,Dolls,46.23,328,42,286
1926,Michael,Toys,Dolls,46.23,100,16,84
1927,Justin,InvalidCategory,Headphones,660.05,399,167,232
1928,NonExistentProduct,Electronics,Headphones,228.82,225,194,31
1929,Shannon,Home & Garden,Gardening Tools,InvalidPrice,436,377,59
1930,Marvin,Clothing,Shirt,995.13,394,18,376
1931,Michael,Toys,Dolls,46.23,244,27,217
1932,NonExistentProduct,Electronics,Mobile,847.43,220,43,177
1933,Pamela,Electronics,Headphones,651.11,166,87,79
1934,Shawn,Electronics,Headphones,461.09,171,19,152
1935,Martha,Books,Fiction,43310.0,279,190,89
1936,NonExistentProduct,Electronics,Mobile,847.43,181,70,111
1937,Jamie,InvalidCategory,Fiction,930.3,221,167,54
1938,Elizabeth,Clothing,Shirt,840.19,491,124,367
1939,NonExistentProduct,Electronics,Headphones,461.09,60,6,54
1940,Pamela,Electronics,Headphones,651.11,109,31,78
1941,Elizabeth,Clothing,Shirt,840.19,420,242,178
1942,Elizabeth,Clothing,Shirt,840.19,374,54,320
1943,Elizabeth,Clothing,Shirt,InvalidPrice,142,33,109
1944,Fred,Books,Academic,InvalidPrice,435,378,57
1945,Amy,Home & Garden,Decor,364.01,317,89,228
1946,Angela,Toys,Action Figures,386.57,240,228,12
1947,Michael,Toys,Dolls,46.23,242,48,194
1948,Amy,Home & Garden,Decor,InvalidPrice,293,174,119
1949,Justin,Electronics,Headphones,0.01,51,25,26
1950,Robert,Electronics,Mobile,847.43,225,7,218
1951,Elizabeth,Clothing,Shirt,840.19,363,20,343
1952,Nathaniel,Electronics,Camera,652.35,216,140,76
1953,Kristine,InvalidCategory,Headphones,228.82,67,33,34
1954,Nathaniel,Electronics,Camera,652.35,225,91,134
1955,Kristine,Electronics,Headphones,22882.0,92,22,70
1956,Angela,InvalidCategory,Action Figures,0.01,349,325,24
1957,Amy,Home & Garden,Decor,364.01,457,181,276
1958,Elizabeth,Clothing,Shirt,840.19,373,115,258
1959,Cynthia,Electronics,Headphones,872.85,80,8,72
1960,Cynthia,Electronics,Headphones,872.85,193,98,95
1961,Jamie,InvalidCategory,Fiction,93030.0,462,199,263
1962,Elizabeth,Clothing,Shirt,840.19,285,123,162
1963,Fred,Books,Academic,0.01,394,15,379
1964,Kristine,Electronics,Headphones,228.82,190,134,56
1965,Katie,Books,Non-fiction,642.11,295,219,76
1966,NonExistentProduct,Electronics,Headphones,872.85,436,311,125
1967,Cynthia,Electronics,Headphones,872.85,499,127,372
1968,Martha,Books,Fiction,433.1,168,112,56
1969,Wanda,Toys,Educational,InvalidPrice,482,134,348
1970,Robert,Electronics,Mobile,847.43,81,36,45
1971,NonExistentProduct,Home & Garden,Decor,InvalidPrice,110,48,62
1972,Jamie,Books,Fiction,930.3,374,274,100
1973,Jamie,Books,Fiction,93030.0,376,218,158
1974,Fred,Books,Academic,951.53,154,64,90
1975,Fred,Books,Academic,InvalidPrice,108,48,60
1976,Anthony,Books,Academic,693.39,334,329,5
1977,Shannon,Home & Garden,Gardening Tools,68.01,258,56,202
1978,Nathaniel,Electronics,Camera,652.35,493,418,75
1979,Fred,Books,Academic,InvalidPrice,273,238,35
1980,Martha,Books,Fiction,433.1,346,313,33
1981,Jamie,InvalidCategory,Fiction,InvalidPrice,242,8,234
1982,Wanda,Toys,Educational,0.01,105,64,41
1983,Martha,Books,Fiction,433.1,221,177,44
1984,Justin,InvalidCategory,Headphones,660.05,500,213,287
1985,Cynthia,InvalidCategory,Headphones,872.85,85,50,35
1986,Jamie,InvalidCategory,Fiction,930.3,471,354,117
1987,Jamie,Books,Fiction,930.3,207,127,80
1988,Jamie,Books,Fiction,930.3,124,56,68
1989,Tammy,InvalidCategory,Furniture,431.82,271,219,52
1990,Amy,Home & Garden,Decor,36401.0,356,280,76
1991,Amy,Home & Garden,Decor,364.01,425,259,166
1992,Nathaniel,Electronics,Camera,0.01,152,23,129
1993,Anthony,Books,Academic,693.39,63,14,49
1994,NonExistentProduct,Toys,Dolls,46.23,282,259,23
1995,Angela,Toys,Action Figures,386.57,156,35,121
1996,Robert,Electronics,Mobile,847.43,316,248,68
1997,Shawn,Electronics,Headphones,46109.0,351,31,320
1998,Pamela,Electronics,Headphones,0.01,346,127,219
1999,Fred,Books,Academic,951.53,292,167,125
2000,Wanda,Toys,Educational,268.61,254,95,159
2001,Robert,Electronics,Mobile,InvalidPrice,292,98,194
2002,NonExistentProduct,Electronics,Headphones,872.85,319,91,228
2003,Martha,Books,Fiction,433.1,63,7,56
2004,Katie,Books,Non-fiction,642.11,302,42,260
2005,Justin,Electronics,Headphones,660.05,456,364,92
2006,Shannon,Home & Garden,Gardening Tools,68.01,436,1,435
2007,Elizabeth,Clothing,Shirt,840.19,428,134,294
2008,Pamela,Electronics,Headphones,651.11,317,143,174
2009,Anthony,Books,Academic,69339.0,431,365,66
2010,Cynthia,InvalidCategory,Headphones,872.85,98,92,6
2011,Wanda,Toys,Educational,268.61,382,344,38
2012,Katie,Books,Non-fiction,642.11,376,360,16
2013,Martha,Books,Fiction,433.1,267,181,86
2014,Tammy,Home & Garden,Furniture,InvalidPrice,109,74,35
2015,Katie,Books,Non-fiction,64211.0,487,275,212
2016,NonExistentProduct,Clothing,Shirt,995.13,324,229,95
2017,NonExistentProduct,Books,Academic,693.39,260,186,74
2018,Fred,Books,Academic,95153.0,244,219,25
2019,Elizabeth,Clothing,Shirt,840.19,411,297,114
2020,Michael,Toys,Dolls,46.23,482,246,236
2021,Pamela,Electronics,Headphones,65111.0,288,177,111
2022,Shawn,Electronics,Headphones,461.09,364,38,326
2023,Kristine,Electronics,Headphones,228.82,429,321,108
2024,Marvin,Clothing,Shirt,995.13,415,32,383
2025,Fred,Books,Academic,951.53,87,25,62
2026,Cynthia,Electronics,Headphones,872.85,349,312,37
2027,Shannon,Home & Garden,Gardening Tools,68.01,225,190,35
2028,Robert,Electronics,Mobile,847.43,405,275,130
2029,Amy,Home & Garden,Decor,99999.99,174,158,16
2030,Jamie,Books,Fiction,930.3,330,88,242
2031,Anthony,Books,Academic,693.39,234,33,201
2032,Michael,Toys,Dolls,InvalidPrice,433,309,124
2033,Michael,Toys,Dolls,0.01,309,83,226
2034,Kristine,Electronics,Headphones,228.82,192,166,26
2035,Nathaniel,Electronics,Camera,652.35,377,301,76
2036,Justin,Electronics,Headphones,99999.99,258,32,226
2037,Katie,Books,Non-fiction,642.11,67,65,2
2038,Marvin,Clothing,Shirt,99513.0,283,65,218
2039,Fred,Books,Academic,951.53,296,11,285
2040,Martha,Books,Fiction,433.1,215,93,122
2041,Shawn,Electronics,Headphones,461.09,108,29,79
2042,NonExistentProduct,Electronics,Headphones,461.09,324,79,245
2043,Pamela,InvalidCategory,Headphones,InvalidPrice,384,312,72
2044,Marvin,InvalidCategory,Shirt,InvalidPrice,201,164,37
2045,Elizabeth,Clothing,Shirt,840.19,212,47,165
2046,Justin,Electronics,Headphones,660.05,252,171,81
2047,Anthony,Books,Academic,693.39,421,148,273
2048,Nathaniel,Electronics,Camera,65235.0,132,102,30
2049,Shannon,Home & Garden,Gardening Tools,68.01,118,20,98
2050,Nathaniel,Electronics,Camera,652.35,239,198,41
2051,NonExistentProduct,Electronics,Headphones,461.09,234,91,143
2052,Tammy,Home & Garden,Furniture,431.82,419,126,293
2053,NonExistentProduct,Books,Academic,693.39,151,12,139
2054,Fred,Books,Academic,951.53,329,25,304
2055,Robert,Electronics,Mobile,InvalidPrice,346,253,93
2056,Anthony,Books,Academic,693.39,58,32,26
2057,Kristine,Electronics,Headphones,228.82,454,305,149
2058,Nathaniel,Electronics,Camera,652.35,162,114,48
2059,Elizabeth,Clothing,Shirt,840.19,92,1,91
2060,Jamie,Books,Fiction,930.3,374,313,61
2061,Cynthia,Electronics,Headphones,99999.99,63,32,31
2062,Tammy,Home & Garden,Furniture,431.82,222,129,93
2063,Shawn,InvalidCategory,Headphones,461.09,324,36,288
2064,Robert,Electronics,Mobile,847.43,325,81,244
2065,Cynthia,Electronics,Headphones,InvalidPrice,155,84,71
2066,Pamela,Electronics,Headphones,651.11,171,79,92
2067,Pamela,Electronics,Headphones,651.11,451,328,123
2068,Martha,Books,Fiction,433.1,58,30,28
2069,Elizabeth,Clothing,Shirt,840.19,311,154,157
2070,Wanda,Toys,Educational,268.61,329,135,194
2071,Jamie,Books,Fiction,930.3,79,36,43
2072,Cynthia,Electronics,Headphones,872.85,87,56,31
2073,NonExistentProduct,Books,Fiction,930.3,259,181,78
2074,NonExistentProduct,Home & Garden,Gardening Tools,68.01,351,200,151
2075,Michael,Toys,Dolls,99999.99,341,42,299
2076,NonExistentProduct,Books,Academic,69339.0,113,39,74
2077,NonExistentProduct,Electronics,Headphones,651.11,50,6,44
2078,Shannon,Home & Garden,Gardening Tools,68.01,180,177,3
2079,Katie,InvalidCategory,Non-fiction,642.11,465,24,441
2080,Tammy,InvalidCategory,Furniture,431.82,204,104,100
2081,Pamela,Electronics,Headphones,651.11,186,116,70
2082,Anthony,Books,Academic,693.39,434,187,247
2083,Cynthia,Electronics,Headphones,872.85,66,22,44
2084,Justin,Electronics,Headphones,660.05,259,184,75
2085,Shawn,InvalidCategory,Headphones,461.09,97,91,6
2086,Robert,Electronics,Mobile,847.43,227,21,206
2087,NonExistentProduct,Home & Garden,Furniture,431.82,374,77,297
2088,Michael,Toys,Dolls,46.23,243,93,150
2089,NonExistentProduct,Books,Fiction,93030.0,396,345,51
2090,Michael,Toys,Dolls,46.23,410,138,272
2091,Wanda,Toys,Educational,26861.0,446,92,354
2092,Elizabeth,Clothing,Shirt,InvalidPrice,337,252,85
2093,NonExistentProduct,InvalidCategory,Non-fiction,642.11,72,64,8
2094,Kristine,Electronics,Headphones,228.82,65,5,60
2095,Fred,Books,Academic,InvalidPrice,416,49,367
2096,Shawn,Electronics,Headphones,461.09,258,146,112
2097,Justin,Electronics,Headphones,0.01,357,119,238
2098,Marvin,Clothing,Shirt,995.13,381,130,251
2099,Robert,Electronics,Mobile,847.43,103,58,45
2100,Fred,Books,Academic,951.53,323,319,4
2101,NonExistentProduct,Electronics,Headphones,99999.99,195,107,88
2102,Shannon,Home & Garden,Gardening Tools,68.01,453,94,359
2103,Angela,Toys,Action Figures,386.57,152,101,51
2104,Amy,Home & Garden,Decor,99999.99,91,84,7
2105,Amy,Home & Garden,Decor,364.01,71,26,45
2106,Amy,Home & Garden,Decor,364.01,124,115,9
2107,Pamela,Electronics,Headphones,651.11,471,156,315
2108,Katie,Books,Non-fiction,642.11,375,271,104
2109,Shannon,Home & Garden,Gardening Tools,68.01,93,63,30
2110,Amy,Home & Garden,Decor,36401.0,482,262,220
2111,Elizabeth,Clothing,Shirt,840.19,163,133,30
2112,Cynthia,Electronics,Headphones,872.85,424,121,303
2113,Kristine,Electronics,Headphones,228.82,283,248,35
2114,Shawn,InvalidCategory,Headphones,461.09,420,240,180
2115,Elizabeth,Clothing,Shirt,84019.0,403,161,242
2116,Robert,Electronics,Mobile,847.43,199,46,153
2117,Shawn,Electronics,Headphones,461.09,397,226,171
2118,Robert,InvalidCategory,Mobile,847.43,450,52,398
2119,Pamela,Electronics,Headphones,651.11,368,324,44
2120,Shawn,Electronics,Headphones,461.09,339,137,202
2121,Jamie,Books,Fiction,930.3,295,85,210
2122,Angela,Toys,Action Figures,InvalidPrice,362,310,52
2123,Kristine,Electronics,Headphones,22882.0,363,105,258
2124,NonExistentProduct,Electronics,Headphones,0.01,420,104,316
2125,Justin,Electronics,Headphones,660.05,107,17,90
2126,Pamela,Electronics,Headphones,0.01,235,202,33
2127,Angela,Toys,Action Figures,386.57,104,64,40
2128,Justin,Electronics,Headphones,660.05,138,137,1
2129,Shawn,Electronics,Headphones,0.01,68,5,63
2130,Amy,Home & Garden,Decor,364.01,464,72,392
2131,Marvin,Clothing,Shirt,995.13,416,82,334
2132,Marvin,Clothing,Shirt,995.13,112,15,97
2133,Marvin,Clothing,Shirt,995.13,364,355,9
2134,Marvin,Clothing,Shirt,99513.0,392,226,166
2135,Elizabeth,Clothing,Shirt,84019.0,215,132,83
2136,Wanda,Toys,Educational,268.61,288,91,197
2137,Wanda,InvalidCategory,Educational,268.61,161,46,115
2138,Jamie,InvalidCategory,Fiction,930.3,434,112,322
2139,Amy,Home & Garden,Decor,364.01,145,4,141
2140,NonExistentProduct,Clothing,Shirt,840.19,290,74,216
2141,Kristine,Electronics,Headphones,InvalidPrice,106,17,89
2142,Wanda,Toys,Educational,99999.99,98,55,43
2143,Angela,Toys,Action Figures,386.57,379,249,130
2144,Shawn,Electronics,Headphones,461.09,381,275,106
2145,Shannon,Home & Garden,Gardening Tools,68.01,329,264,65
2146,Anthony,Books,Academic,693.39,396,319,77
2147,Tammy,Home & Garden,Furniture,431.82,364,362,2
2148,Wanda,Toys,Educational,99999.99,449,334,115
2149,Shawn,Electronics,Headphones,461.09,192,12,180
2150,Justin,Electronics,Headphones,660.05,341,202,139
2151,Marvin,Clothing,Shirt,995.13,341,303,38
2152,Fred,Books,Academic,951.53,169,116,53
2153,Pamela,Electronics,Headphones,651.11,257,208,49
2154,Fred,Books,Academic,InvalidPrice,365,22,343
2155,Shawn,Electronics,Headphones,461.09,183,159,24
2156,NonExistentProduct,Electronics,Headphones,872.85,199,198,1
2157,Amy,Home & Garden,Decor,364.01,202,1,201
2158,Justin,Electronics,Headphones,660.05,369,2,367
2159,NonExistentProduct,Electronics,Headphones,872.85,130,14,116
2160,Amy,Home & Garden,Decor,364.01,66,65,1
2161,Nathaniel,Electronics,Camera,652.35,64,47,17
2162,Kristine,InvalidCategory,Headphones,InvalidPrice,185,16,169
2163,Robert,Electronics,Mobile,847.43,213,182,31
2164,Robert,Electronics,Mobile,847.43,202,103,99
2165,Elizabeth,Clothing,Shirt,840.19,445,1,444
2166,Katie,Books,Non-fiction,InvalidPrice,61,32,29
2167,Amy,Home & Garden,Decor,InvalidPrice,472,415,57
2168,Elizabeth,Clothing,Shirt,99999.99,480,20,460
2169,Shawn,Electronics,Headphones,461.09,391,92,299
2170,Michael,Toys,Dolls,46.23,252,237,15
2171,Shawn,Electronics,Headphones,0.01,369,215,154
2172,Nathaniel,Electronics,Camera,652.35,236,131,105
2173,NonExistentProduct,Electronics,Headphones,651.11,93,50,43
2174,Angela,Toys,Action Figures,38657.0,429,236,193
2175,Justin,Electronics,Headphones,660.05,137,51,86
2176,Michael,Toys,Dolls,46.23,110,108,2
2177,Cynthia,Electronics,Headphones,InvalidPrice,164,56,108
2178,Shawn,Electronics,Headphones,0.01,233,128,105
2179,Cynthia,Electronics,Headphones,872.85,358,159,199
2180,Elizabeth,Clothing,Shirt,InvalidPrice,320,274,46
2181,Shannon,Home & Garden,Gardening Tools,68.01,491,454,37
2182,Robert,Electronics,Mobile,InvalidPrice,64,50,14
2183,Justin,Electronics,Headphones,660.05,272,113,159
2184,Robert,Electronics,Mobile,99999.99,124,19,105
2185,Michael,InvalidCategory,Dolls,46.23,464,180,284
2186,Wanda,Toys,Educational,268.61,222,71,151
2187,NonExistentProduct,InvalidCategory,Headphones,461.09,337,209,128
2188,Amy,Home & Garden,Decor,364.01,210,170,40
2189,Shawn,Electronics,Headphones,461.09,81,19,62
2190,Amy,Home & Garden,Decor,364.01,144,85,59
2191,Fred,Books,Academic,95153.0,499,129,370
2192,NonExistentProduct,Clothing,Shirt,0.01,195,93,102
2193,Kristine,Electronics,Headphones,228.82,300,77,223
2194,Angela,Toys,Action Figures,386.57,342,5,337
2195,Justin,Electronics,Headphones,66005.0,142,90,52
2196,Elizabeth,Clothing,Shirt,840.19,206,84,122
2197,Wanda,InvalidCategory,Educational,0.01,472,150,322
2198,Katie,Books,Non-fiction,642.11,365,15,350
2199,Robert,Electronics,Mobile,847.43,267,83,184
2200,Robert,Electronics,Mobile,99999.99,317,81,236
2201,Marvin,Clothing,Shirt,99513.0,421,72,349
2202,Cynthia,Electronics,Headphones,InvalidPrice,386,274,112
2203,Tammy,Home & Garden,Furniture,431.82,420,348,72
2204,Kristine,Electronics,Headphones,22882.0,282,170,112
2205,Angela,Toys,Action Figures,386.57,368,72,296
2206,Justin,Electronics,Headphones,660.05,67,36,31
2207,Kristine,Electronics,Headphones,228.82,331,140,191
2208,NonExistentProduct,Books,Fiction,InvalidPrice,94,35,59
2209,Tammy,Home & Garden,Furniture,431.82,299,3,296
2210,Nathaniel,Electronics,Camera,InvalidPrice,237,190,47
2211,Marvin,Clothing,Shirt,995.13,376,189,187
2212,Wanda,Toys,Educational,268.61,107,107,0
2213,Shawn,Electronics,Headphones,461.09,303,125,178
2214,Tammy,Home & Garden,Furniture,431.82,370,98,272
2215,Michael,Toys,Dolls,46.23,398,190,208
2216,Justin,Electronics,Headphones,660.05,472,434,38
2217,Fred,Books,Academic,951.53,469,299,170
2218,Jamie,Books,Fiction,930.3,331,160,171
2219,NonExistentProduct,Toys,Dolls,46.23,283,235,48
2220,Martha,Books,Fiction,433.1,210,28,182
2221,Michael,Toys,Dolls,46.23,481,341,140
2222,Fred,Books,Academic,99999.99,89,10,79
2223,Kristine,Electronics,Headphones,99999.99,245,47,198
2224,Tammy,Home & Garden,Furniture,431.82,141,122,19
2225,Katie,Books,Non-fiction,642.11,411,2,409
2226,Cynthia,Electronics,Headphones,872.85,340,297,43
2227,Cynthia,Electronics,Headphones,872.85,443,312,131
2228,Anthony,Books,Academic,693.39,444,394,50
2229,Pamela,Electronics,Headphones,651.11,395,18,377
2230,Marvin,Clothing,Shirt,995.13,417,37,380
2231,Martha,Books,Fiction,433.1,229,35,194
2232,Marvin,Clothing,Shirt,995.13,490,63,427
2233,Justin,InvalidCategory,Headphones,660.05,424,307,117
2234,Anthony,Books,Academic,0.01,183,127,56
2235,Marvin,Clothing,Shirt,995.13,335,13,322
2236,Michael,Toys,Dolls,0.01,232,199,33
2237,NonExistentProduct,InvalidCategory,Headphones,46109.0,444,17,427
2238,Tammy,Home & Garden,Furniture,431.82,275,73,202
2239,Kristine,Electronics,Headphones,228.82,436,299,137
2240,Michael,Toys,Dolls,99999.99,426,153,273
2241,NonExistentProduct,Toys,Dolls,InvalidPrice,159,22,137
2242,NonExistentProduct,Electronics,Headphones,872.85,308,90,218
2243,Marvin,Clothing,Shirt,995.13,500,219,281
2244,Nathaniel,Electronics,Camera,652.35,244,13,231
2245,Amy,InvalidCategory,Decor,364.01,455,204,251
2246,Nathaniel,Electronics,Camera,652.35,423,332,91
2247,Jamie,Books,Fiction,930.3,293,188,105
2248,Jamie,Books,Fiction,930.3,466,360,106
2249,Jamie,Books,Fiction,930.3,258,153,105
2250,Robert,Electronics,Mobile,84743.0,60,12,48
2251,Tammy,Home & Garden,Furniture,43182.0,233,26,207
2252,Pamela,Electronics,Headphones,651.11,473,281,192
2253,Martha,Books,Fiction,433.1,110,91,19
2254,Justin,Electronics,Headphones,660.05,301,214,87
2255,Jamie,Books,Fiction,930.3,173,68,105
2256,Amy,InvalidCategory,Decor,364.01,312,71,241
2257,Amy,Home & Garden,Decor,364.01,279,95,184
2258,Marvin,Clothing,Shirt,995.13,129,65,64
2259,Michael,Toys,Dolls,46.23,379,123,256
2260,Cynthia,Electronics,Headphones,872.85,169,101,68
2261,Justin,Electronics,Headphones,660.05,162,161,1
2262,Shawn,Electronics,Headphones,InvalidPrice,57,17,40
2263,Elizabeth,Clothing,Shirt,84019.0,311,182,129
2264,Tammy,Home & Garden,Furniture,0.01,50,25,25
2265,Wanda,Toys,Educational,268.61,284,246,38
2266,Anthony,InvalidCategory,Academic,693.39,218,12,206
2267,Wanda,Toys,Educational,268.61,297,200,97
2268,Kristine,Electronics,Headphones,228.82,477,376,101
2269,Fred,Books,Academic,951.53,418,20,398
2270,Amy,Home & Garden,Decor,364.01,332,173,159
2271,Katie,InvalidCategory,Non-fiction,642.11,269,5,264
2272,Robert,Electronics,Mobile,84743.0,176,63,113
2273,Marvin,Clothing,Shirt,995.13,343,196,147
2274,Michael,Toys,Dolls,46.23,322,211,111
2275,Kristine,Electronics,Headphones,228.82,377,250,127
2276,NonExistentProduct,Books,Non-fiction,99999.99,180,138,42
2277,Pamela,Electronics,Headphones,InvalidPrice,293,276,17
2278,Kristine,Electronics,Headphones,0.01,185,108,77
2279,Michael,Toys,Dolls,4623.0,155,132,23
2280,Pamela,Electronics,Headphones,651.11,243,164,79
2281,Robert,Electronics,Mobile,847.43,480,120,360
2282,Robert,Electronics,Mobile,99999.99,405,179,226
2283,Martha,Books,Fiction,InvalidPrice,326,32,294
2284,NonExistentProduct,Toys,Educational,268.61,97,2,95
2285,Martha,Books,Fiction,433.1,435,117,318
2286,Amy,Home & Garden,Decor,364.01,217,49,168
2287,Anthony,Books,Academic,693.39,372,45,327
2288,Pamela,Electronics,Headphones,InvalidPrice,290,193,97
2289,Nathaniel,Electronics,Camera,InvalidPrice,428,304,124
2290,Nathaniel,Electronics,Camera,652.35,165,28,137
2291,Justin,Electronics,Headphones,660.05,252,193,59
2292,Jamie,Books,Fiction,930.3,364,210,154
2293,Anthony,Books,Academic,693.39,387,380,7
2294,NonExistentProduct,Books,Fiction,433.1,185,53,132
2295,Marvin,Clothing,Shirt,995.13,479,214,265
2296,Wanda,Toys,Educational,268.61,210,63,147
2297,Cynthia,Electronics,Headphones,InvalidPrice,335,243,92
2298,NonExistentProduct,Toys,Action Figures,386.57,438,393,45
2299,Elizabeth,Clothing,Shirt,0.01,240,224,16
2300,Anthony,Books,Academic,693.39,209,132,77
2301,Elizabeth,Clothing,Shirt,840.19,143,113,30
2302,Wanda,Toys,Educational,268.61,102,11,91
2303,Elizabeth,Clothing,Shirt,840.19,354,110,244
2304,Cynthia,Electronics,Headphones,872.85,192,109,83
2305,Robert,Electronics,Mobile,847.43,211,19,192
2306,Cynthia,InvalidCategory,Headphones,872.85,91,10,81
2307,NonExistentProduct,Toys,Educational,268.61,299,116,183
2308,Michael,Toys,Dolls,46.23,348,312,36
2309,Jamie,Books,Fiction,930.3,500,372,128
2310,NonExistentProduct,Clothing,Shirt,995.13,261,72,189
2311,Anthony,Books,Academic,693.39,209,121,88
2312,NonExistentProduct,InvalidCategory,Gardening Tools,68.01,245,136,109
2313,Kristine,Electronics,Headphones,InvalidPrice,388,325,63
2314,Justin,Electronics,Headphones,660.05,85,69,16
2315,Nathaniel,Electronics,Camera,652.35,170,1,169
2316,Shawn,InvalidCategory,Headphones,461.09,89,69,20
2317,Fred,Books,Academic,InvalidPrice,273,244,29
2318,Justin,Electronics,Headphones,660.05,482,20,462
2319,Martha,Books,Fiction,433.1,334,121,213
2320,Michael,Toys,Dolls,46.23,407,268,139
2321,Elizabeth,Clothing,Shirt,840.19,78,75,3
2322,Fred,Books,Academic,951.53,266,111,155
2323,Katie,Books,Non-fiction,642.11,377,29,348
2324,Shawn,Electronics,Headphones,46109.0,250,36,214
2325,Pamela,Electronics,Headphones,InvalidPrice,201,51,150
2326,Justin,Electronics,Headphones,0.01,147,53,94
2327,Angela,Toys,Action Figures,386.57,385,379,6
2328,Wanda,Toys,Educational,InvalidPrice,260,14,246
2329,Katie,Books,Non-fiction,642.11,60,23,37
2330,Michael,Toys,Dolls,46.23,330,83,247
2331,Tammy,InvalidCategory,Furniture,431.82,423,4,419
2332,Kristine,Electronics,Headphones,228.82,79,63,16
2333,Shawn,Electronics,Headphones,InvalidPrice,83,33,50
2334,Shannon,Home & Garden,Gardening Tools,68.01,261,193,68
2335,Cynthia,Electronics,Headphones,99999.99,207,164,43
2336,Michael,Toys,Dolls,46.23,205,103,102
2337,Marvin,InvalidCategory,Shirt,995.13,242,12,230
2338,Shawn,Electronics,Headphones,461.09,357,56,301
2339,Michael,InvalidCategory,Dolls,46.23,168,49,119
2340,Angela,Toys,Action Figures,386.57,287,64,223
2341,Kristine,Electronics,Headphones,22882.0,466,274,192
2342,Marvin,Clothing,Shirt,InvalidPrice,304,209,95
2343,Tammy,Home & Garden,Furniture,InvalidPrice,185,76,109
2344,NonExistentProduct,Electronics,Camera,652.35,443,252,191
2345,Anthony,Books,Academic,99999.99,404,66,338
2346,Kristine,Electronics,Headphones,228.82,321,253,68
2347,Michael,Toys,Dolls,46.23,202,136,66
2348,Cynthia,Electronics,Headphones,872.85,393,62,331
2349,Wanda,Toys,Educational,268.61,390,334,56
2350,Angela,Toys,Action Figures,386.57,463,6,457
2351,Robert,Electronics,Mobile,84743.0,136,60,76
2352,Anthony,Books,Academic,693.39,214,156,58
2353,NonExistentProduct,Electronics,Headphones,InvalidPrice,274,128,146
2354,Michael,Toys,Dolls,46.23,496,257,239
2355,Pamela,Electronics,Headphones,651.11,377,316,61
2356,Shawn,Electronics,Headphones,461.09,472,96,376
2357,Robert,Electronics,Mobile,847.43,153,24,129
2358,Angela,Toys,Action Figures,386.57,189,75,114
2359,Anthony,Books,Academic,693.39,88,27,61
2360,Jamie,Books,Fiction,930.3,377,59,318
2361,Robert,Electronics,Mobile,99999.99,461,226,235
2362,NonExistentProduct,Books,Non-fiction,642.11,179,143,36
2363,Angela,Toys,Action Figures,386.57,78,13,65
2364,Kristine,Electronics,Headphones,0.01,399,285,114
2365,Cynthia,Electronics,Headphones,99999.99,367,251,116
2366,Nathaniel,Electronics,Camera,InvalidPrice,385,233,152
2367,Wanda,Toys,Educational,268.61,424,338,86
2368,Michael,Toys,Dolls,4623.0,448,1,447
2369,Jamie,Books,Fiction,930.3,308,159,149
2370,Martha,Books,Fiction,43310.0,476,164,312
2371,Robert,Electronics,Mobile,847.43,282,48,234
2372,Nathaniel,Electronics,Camera,99999.99,253,162,91
2373,Tammy,Home & Garden,Furniture,InvalidPrice,201,194,7
2374,Robert,Electronics,Mobile,847.43,70,10,60
2375,Katie,Books,Non-fiction,99999.99,302,64,238
2376,Anthony,InvalidCategory,Academic,693.39,479,195,284
2377,NonExistentProduct,Books,Fiction,433.1,286,186,100
2378,Pamela,Electronics,Headphones,0.01,201,60,141
2379,Anthony,Books,Academic,InvalidPrice,322,293,29
2380,Justin,Electronics,Headphones,InvalidPrice,305,31,274
2381,Michael,Toys,Dolls,46.23,365,28,337
2382,Anthony,Books,Academic,69339.0,147,147,0
2383,Justin,Electronics,Headphones,InvalidPrice,120,16,104
2384,Fred,Books,Academic,951.53,132,10,122
2385,Martha,Books,Fiction,43310.0,489,59,430
2386,Justin,Electronics,Headphones,660.05,484,202,282
2387,NonExistentProduct,Toys,Educational,268.61,187,111,76
2388,Fred,Books,Academic,InvalidPrice,176,44,132
2389,Marvin,Clothing,Shirt,995.13,68,13,55
2390,Anthony,Books,Academic,693.39,423,254,169
2391,Shannon,Home & Garden,Gardening Tools,68.01,375,306,69
2392,Kristine,Electronics,Headphones,228.82,384,241,143
2393,Tammy,InvalidCategory,Furniture,431.82,58,7,51
2394,Marvin,Clothing,Shirt,995.13,387,355,32
2395,NonExistentProduct,InvalidCategory,Camera,652.35,61,34,27
2396,Elizabeth,Clothing,Shirt,840.19,430,414,16
2397,NonExistentProduct,Home & Garden,Furniture,431.82,215,126,89
2398,Fred,Books,Academic,95153.0,361,106,255
2399,Marvin,Clothing,Shirt,0.01,108,26,82
2400,Martha,Books,Fiction,433.1,51,19,32
2401,Anthony,Books,Academic,693.39,233,161,72
2402,Cynthia,Electronics,Headphones,872.85,241,39,202
2403,Fred,Books,Academic,951.53,293,216,77
2404,Wanda,Toys,Educational,268.61,165,23,142
2405,Angela,Toys,Action Figures,386.57,455,216,239
2406,NonExistentProduct,Electronics,Headphones,66005.0,456,403,53
2407,NonExistentProduct,Electronics,Camera,652.35,444,36,408
2408,Anthony,Books,Academic,InvalidPrice,311,157,154
2409,NonExistentProduct,Electronics,Headphones,228.82,215,202,13
2410,Katie,Books,Non-fiction,InvalidPrice,211,120,91
2411,Katie,InvalidCategory,Non-fiction,642.11,161,89,72
2412,Martha,Books,Fiction,433.1,420,292,128
2413,Michael,Toys,Dolls,4623.0,318,228,90
2414,Cynthia,Electronics,Headphones,87285.0,426,390,36
2415,NonExistentProduct,Clothing,Shirt,995.13,398,57,341
2416,Kristine,Electronics,Headphones,InvalidPrice,123,28,95
2417,Cynthia,Electronics,Headphones,872.85,458,55,403
2418,Michael,Toys,Dolls,46.23,305,111,194
2419,Justin,Electronics,Headphones,660.05,305,132,173
2420,Martha,Books,Fiction,433.1,443,146,297
2421,Angela,Toys,Action Figures,386.57,361,347,14
2422,Katie,Books,Non-fiction,642.11,66,17,49
2423,Marvin,Clothing,Shirt,99999.99,456,447,9
2424,Katie,Books,Non-fiction,642.11,108,71,37
2425,Shawn,Electronics,Headphones,461.09,135,50,85
2426,Angela,Toys,Action Figures,38657.0,407,1,406
2427,Anthony,Books,Academic,693.39,133,93,40
2428,Anthony,Books,Academic,InvalidPrice,101,64,37
2429,Fred,Books,Academic,951.53,462,202,260
2430,Robert,Electronics,Mobile,847.43,180,133,47
2431,Jamie,Books,Fiction,930.3,270,268,2
2432,Robert,Electronics,Mobile,InvalidPrice,271,25,246
2433,Michael,Toys,Dolls,46.23,371,237,134
2434,Shannon,Home & Garden,Gardening Tools,68.01,162,101,61
2435,Fred,Books,Academic,95153.0,178,71,107
2436,Justin,Electronics,Headphones,66005.0,184,71,113
2437,Martha,Books,Fiction,433.1,99,7,92
2438,Katie,Books,Non-fiction,64211.0,131,124,7
2439,Pamela,Electronics,Headphones,651.11,304,106,198
2440,Shannon,Home & Garden,Gardening Tools,68.01,157,79,78
2441,Nathaniel,Electronics,Camera,652.35,231,152,79
2442,Angela,Toys,Action Figures,386.57,500,93,407
2443,Anthony,Books,Academic,693.39,114,12,102
2444,Elizabeth,Clothing,Shirt,840.19,129,7,122
2445,Angela,InvalidCategory,Action Figures,38657.0,66,39,27
2446,Wanda,Toys,Educational,0.01,322,31,291
2447,NonExistentProduct,Toys,Educational,26861.0,451,147,304
2448,NonExistentProduct,Toys,Educational,268.61,432,394,38
2449,Nathaniel,Electronics,Camera,InvalidPrice,415,307,108
2450,Robert,Electronics,Mobile,847.43,70,17,53
2451,Fred,Books,Academic,InvalidPrice,375,295,80
2452,Shannon,Home & Garden,Gardening Tools,68.01,111,22,89
2453,Amy,InvalidCategory,Decor,0.01,160,19,141
2454,Angela,Toys,Action Figures,386.57,436,158,278
2455,Shawn,InvalidCategory,Headphones,99999.99,87,84,3
2456,Fred,Books,Academic,951.53,485,389,96
2457,Amy,Home & Garden,Decor,364.01,391,175,216
2458,Marvin,Clothing,Shirt,InvalidPrice,467,62,405
2459,Anthony,Books,Academic,693.39,361,21,340
2460,Robert,Electronics,Mobile,847.43,81,9,72
2461,Anthony,Books,Academic,693.39,433,141,292
2462,Pamela,Electronics,Headphones,651.11,145,145,0
2463,Shawn,Electronics,Headphones,461.09,132,82,50
2464,NonExistentProduct,Home & Garden,Decor,364.01,417,294,123
2465,Robert,Electronics,Mobile,847.43,101,56,45
2466,Marvin,Clothing,Shirt,995.13,408,337,71
2467,Anthony,Books,Academic,0.01,336,237,99
2468,Nathaniel,Electronics,Camera,652.35,53,52,1
2469,Marvin,Clothing,Shirt,995.13,210,112,98
2470,Fred,Books,Academic,951.53,104,99,5
2471,Kristine,Electronics,Headphones,228.82,380,205,175
2472,Marvin,Clothing,Shirt,995.13,132,71,61
2473,Angela,Toys,Action Figures,386.57,112,46,66
2474,Wanda,Toys,Educational,268.61,222,61,161
2475,Marvin,Clothing,Shirt,InvalidPrice,446,410,36
2476,Katie,InvalidCategory,Non-fiction,642.11,207,189,18
2477,Martha,Books,Fiction,99999.99,384,114,270
2478,Fred,Books,Academic,951.53,322,65,257
2479,Anthony,InvalidCategory,Academic,693.39,140,45,95
2480,Shawn,Electronics,Headphones,461.09,419,112,307
2481,Amy,InvalidCategory,Decor,364.01,69,7,62
2482,Justin,Electronics,Headphones,660.05,296,95,201
2483,NonExistentProduct,Electronics,Headphones,651.11,89,34,55
2484,Fred,Books,Academic,951.53,193,161,32
2485,Fred,Books,Academic,951.53,311,277,34
2486,NonExistentProduct,Electronics,Headphones,228.82,376,9,367
2487,Kristine,Electronics,Headphones,228.82,253,151,102
2488,Anthony,InvalidCategory,Academic,693.39,195,180,15
2489,Pamela,Electronics,Headphones,651.11,54,25,29
2490,Elizabeth,Clothing,Shirt,InvalidPrice,322,64,258
2491,Justin,Electronics,Headphones,660.05,372,329,43
2492,Shawn,Electronics,Headphones,461.09,369,105,264
2493,Fred,Books,Academic,951.53,366,133,233
2494,NonExistentProduct,Electronics,Mobile,847.43,417,96,321
2495,Shawn,Electronics,Headphones,461.09,173,136,37
2496,Kristine,Electronics,Headphones,228.82,266,220,46
2497,NonExistentProduct,Electronics,Headphones,651.11,160,44,116
2498,Shawn,Electronics,Headphones,461.09,159,145,14
2499,Elizabeth,Clothing,Shirt,840.19,58,16,42
2500,Michael,Toys,Dolls,4623.0,443,251,192
2501,Pamela,Electronics,Headphones,99999.99,419,116,303
2502,Jamie,Books,Fiction,93030.0,217,197,20
2503,Kristine,Electronics,Headphones,228.82,270,214,56
2504,Cynthia,Electronics,Headphones,872.85,434,152,282
2505,Kristine,Electronics,Headphones,228.82,489,102,387
2506,Tammy,Home & Garden,Furniture,431.82,118,87,31
2507,Katie,Books,Non-fiction,642.11,59,51,8
2508,Michael,Toys,Dolls,4623.0,94,58,36
2509,Fred,Books,Academic,InvalidPrice,436,157,279
2510,Anthony,Books,Academic,69339.0,195,174,21
2511,Fred,Books,Academic,0.01,323,143,180
2512,Shannon,Home & Garden,Gardening Tools,99999.99,467,111,356
2513,Jamie,Books,Fiction,930.3,464,445,19
2514,Nathaniel,Electronics,Camera,652.35,263,230,33
2515,Katie,Books,Non-fiction,InvalidPrice,241,59,182
2516,Shawn,Electronics,Headphones,461.09,292,103,189
2517,Kristine,Electronics,Headphones,0.01,230,223,7
2518,NonExistentProduct,Books,Fiction,433.1,471,97,374
2519,Fred,Books,Academic,951.53,244,83,161
2520,Angela,Toys,Action Figures,38657.0,211,72,139
2521,Fred,Books,Academic,951.53,426,328,98
2522,Michael,Toys,Dolls,InvalidPrice,198,144,54
2523,NonExistentProduct,Books,Fiction,930.3,53,45,8
2524,Robert,Electronics,Mobile,847.43,174,7,167
2525,Michael,Toys,Dolls,InvalidPrice,139,18,121
2526,Justin,Electronics,Headphones,660.05,422,341,81
2527,Michael,Toys,Dolls,99999.99,215,65,150
2528,Anthony,Books,Academic,693.39,243,82,161
2529,Shannon,Home & Garden,Gardening Tools,68.01,251,76,175
2530,Robert,Electronics,Mobile,847.43,66,39,27
2531,Shawn,Electronics,Headphones,461.09,258,182,76
2532,Shawn,Electronics,Headphones,461.09,222,197,25
2533,Pamela,Electronics,Headphones,651.11,453,14,439
2534,Kristine,Electronics,Headphones,228.82,351,320,31
2535,Jamie,Books,Fiction,930.3,97,68,29
2536,NonExistentProduct,Electronics,Headphones,461.09,270,10,260
2537,Shawn,Electronics,Headphones,461.09,182,32,150
2538,Nathaniel,Electronics,Camera,65235.0,375,39,336
2539,Justin,Electronics,Headphones,660.05,406,102,304
2540,Shawn,Electronics,Headphones,461.09,474,226,248
2541,Justin,Electronics,Headphones,66005.0,320,206,114
2542,Amy,Home & Garden,Decor,0.01,292,50,242
2543,Shannon,Home & Garden,Gardening Tools,68.01,248,8,240
2544,Tammy,Home & Garden,Furniture,431.82,479,220,259
2545,Shannon,Home & Garden,Gardening Tools,68.01,449,70,379
2546,Fred,Books,Academic,951.53,414,262,152
2547,Cynthia,Electronics,Headphones,872.85,419,394,25
2548,Cynthia,Electronics,Headphones,872.85,380,103,277
2549,Martha,Books,Fiction,433.1,330,304,26
2550,Pamela,Electronics,Headphones,651.11,347,285,62
2551,Shawn,InvalidCategory,Headphones,461.09,293,250,43
2552,Jamie,Books,Fiction,0.01,146,42,104
2553,Wanda,Toys,Educational,268.61,440,331,109
2554,Elizabeth,Clothing,Shirt,840.19,391,258,133
2555,Shannon,Home & Garden,Gardening Tools,0.01,298,176,122
2556,Shawn,Electronics,Headphones,461.09,331,285,46
2557,Justin,Electronics,Headphones,660.05,499,245,254
2558,Pamela,Electronics,Headphones,InvalidPrice,371,328,43
2559,Jamie,Books,Fiction,930.3,94,60,34
2560,Shannon,Home & Garden,Gardening Tools,6801.000000000001,132,89,43
2561,Nathaniel,Electronics,Camera,652.35,59,4,55
2562,Robert,Electronics,Mobile,847.43,233,55,178
2563,Robert,Electronics,Mobile,99999.99,298,230,68
2564,Shawn,Electronics,Headphones,461.09,213,91,122
2565,NonExistentProduct,Books,Academic,693.39,107,51,56
2566,Tammy,Home & Garden,Furniture,431.82,390,10,380
2567,Wanda,Toys,Educational,268.61,389,51,338
2568,Jamie,Books,Fiction,930.3,397,70,327
2569,Wanda,Toys,Educational,26861.0,122,27,95
2570,Shannon,Home & Garden,Gardening Tools,68.01,140,98,42
2571,Cynthia,InvalidCategory,Headphones,872.85,154,126,28
2572,Elizabeth,Clothing,Shirt,840.19,396,62,334
2573,Amy,Home & Garden,Decor,364.01,223,189,34
2574,Martha,Books,Fiction,433.1,434,419,15
2575,Shannon,Home & Garden,Gardening Tools,68.01,218,203,15
2576,Justin,Electronics,Headphones,660.05,134,97,37
2577,Jamie,Books,Fiction,93030.0,261,191,70
2578,Justin,Electronics,Headphones,660.05,292,187,105
2579,Shawn,Electronics,Headphones,461.09,154,83,71
2580,Katie,Books,Non-fiction,642.11,212,98,114
2581,Fred,Books,Academic,951.53,269,101,168
2582,Marvin,Clothing,Shirt,995.13,61,24,37
2583,Cynthia,Electronics,Headphones,872.85,74,45,29
2584,Shannon,Home & Garden,Gardening Tools,68.01,155,57,98
2585,Katie,InvalidCategory,Non-fiction,642.11,201,14,187
2586,Jamie,Books,Fiction,930.3,274,163,111
2587,Wanda,Toys,Educational,268.61,380,93,287
2588,Kristine,Electronics,Headphones,228.82,191,125,66
2589,NonExistentProduct,Electronics,Mobile,84743.0,462,179,283
2590,NonExistentProduct,Toys,Action Figures,386.57,263,183,80
2591,NonExistentProduct,Home & Garden,Furniture,431.82,228,28,200
2592,Amy,Home & Garden,Decor,364.01,112,56,56
2593,Robert,Electronics,Mobile,847.43,474,217,257
2594,Pamela,Electronics,Headphones,651.11,238,160,78
2595,Elizabeth,Clothing,Shirt,840.19,198,69,129
2596,Kristine,Electronics,Headphones,22882.0,376,131,245
2597,Fred,Books,Academic,951.53,225,73,152
2598,Nathaniel,Electronics,Camera,65235.0,380,184,196
2599,Katie,Books,Non-fiction,0.01,477,419,58
2600,Fred,Books,Academic,99999.99,279,9,270
2601,Nathaniel,Electronics,Camera,652.35,338,143,195
2602,Justin,Electronics,Headphones,660.05,226,124,102
2603,Shawn,Electronics,Headphones,461.09,410,373,37
2604,Michael,Toys,Dolls,46.23,87,35,52
2605,Amy,InvalidCategory,Decor,364.01,102,64,38
2606,Fred,Books,Academic,951.53,82,78,4
2607,Amy,Home & Garden,Decor,364.01,439,173,266
2608,Martha,Books,Fiction,433.1,307,152,155
2609,Martha,Books,Fiction,433.1,448,99,349
2610,Anthony,Books,Academic,0.01,307,83,224
2611,Robert,Electronics,Mobile,InvalidPrice,277,217,60
2612,Katie,InvalidCategory,Non-fiction,642.11,440,172,268
2613,NonExistentProduct,InvalidCategory,Academic,95153.0,97,75,22
2614,Katie,Books,Non-fiction,642.11,223,153,70
2615,Robert,Electronics,Mobile,84743.0,209,193,16
2616,Justin,InvalidCategory,Headphones,660.05,145,102,43
2617,Justin,Electronics,Headphones,660.05,254,107,147
2618,Martha,InvalidCategory,Fiction,433.1,329,274,55
2619,NonExistentProduct,Books,Academic,951.53,195,171,24
2620,Elizabeth,InvalidCategory,Shirt,84019.0,124,112,12
2621,Cynthia,Electronics,Headphones,872.85,281,241,40
2622,Cynthia,Electronics,Headphones,872.85,298,283,15
2623,Shannon,Home & Garden,Gardening Tools,6801.000000000001,123,91,32
2624,Marvin,Clothing,Shirt,995.13,345,61,284
2625,Nathaniel,InvalidCategory,Camera,652.35,469,420,49
2626,Robert,Electronics,Mobile,84743.0,107,57,50
2627,Anthony,Books,Academic,693.39,445,62,383
2628,Amy,Home & Garden,Decor,364.01,206,194,12
2629,Cynthia,Electronics,Headphones,872.85,452,344,108
2630,Katie,Books,Non-fiction,642.11,368,100,268
2631,NonExistentProduct,Books,Fiction,433.1,487,318,169
2632,Shannon,Home & Garden,Gardening Tools,68.01,343,334,9
2633,Justin,Electronics,Headphones,99999.99,218,165,53
2634,Kristine,Electronics,Headphones,228.82,461,98,363
2635,NonExistentProduct,Books,Fiction,43310.0,168,167,1
2636,Michael,Toys,Dolls,0.01,119,24,95
2637,Amy,InvalidCategory,Decor,36401.0,463,24,439
2638,Justin,Electronics,Headphones,660.05,90,32,58
2639,Angela,Toys,Action Figures,99999.99,136,12,124
2640,Cynthia,Electronics,Headphones,872.85,320,312,8
2641,Wanda,Toys,Educational,InvalidPrice,430,352,78
2642,Amy,InvalidCategory,Decor,364.01,126,110,16
2643,Marvin,InvalidCategory,Shirt,0.01,492,380,112
2644,Martha,Books,Fiction,433.1,255,35,220
2645,Michael,Toys,Dolls,4623.0,78,62,16
2646,Cynthia,Electronics,Headphones,872.85,500,477,23
2647,Wanda,Toys,Educational,268.61,148,71,77
2648,Shannon,Home & Garden,Gardening Tools,68.01,110,110,0
2649,Jamie,Books,Fiction,930.3,323,212,111
2650,Tammy,Home & Garden,Furniture,431.82,284,46,238
2651,Marvin,InvalidCategory,Shirt,99513.0,359,30,329
2652,Nathaniel,Electronics,Camera,652.35,108,4,104
2653,NonExistentProduct,Clothing,Shirt,995.13,119,65,54
2654,Cynthia,Electronics,Headphones,872.85,433,60,373
2655,Tammy,Home & Garden,Furniture,431.82,207,159,48
2656,Shannon,Home & Garden,Gardening Tools,68.01,72,37,35
2657,Shannon,Home & Garden,Gardening Tools,68.01,312,50,262
2658,Martha,Books,Fiction,433.1,65,9,56
2659,Marvin,Clothing,Shirt,995.13,80,9,71
2660,Elizabeth,Clothing,Shirt,840.19,400,100,300
2661,Elizabeth,Clothing,Shirt,840.19,446,430,16
2662,Elizabeth,Clothing,Shirt,840.19,189,16,173
2663,Robert,Electronics,Mobile,847.43,279,137,142
2664,Angela,Toys,Action Figures,386.57,448,95,353
2665,Anthony,Books,Academic,693.39,395,265,130
2666,Wanda,Toys,Educational,268.61,95,15,80
2667,Shannon,Home & Garden,Gardening Tools,68.01,408,214,194
2668,Robert,Electronics,Mobile,847.43,237,96,141
2669,Michael,Toys,Dolls,99999.99,421,48,373
2670,Robert,Electronics,Mobile,847.43,368,178,190
2671,Cynthia,Electronics,Headphones,InvalidPrice,69,45,24
2672,NonExistentProduct,Toys,Dolls,4623.0,131,37,94
2673,Marvin,Clothing,Shirt,995.13,215,56,159
2674,Tammy,Home & Garden,Furniture,0.01,203,54,149
2675,Elizabeth,Clothing,Shirt,840.19,142,14,128
2676,Robert,Electronics,Mobile,847.43,333,265,68
2677,Wanda,Toys,Educational,268.61,74,2,72
2678,Michael,Toys,Dolls,InvalidPrice,222,110,112
2679,Angela,Toys,Action Figures,InvalidPrice,361,320,41
2680,NonExistentProduct,Electronics,Mobile,847.43,353,105,248
2681,Shawn,Electronics,Headphones,461.09,199,83,116
2682,Kristine,Electronics,Headphones,228.82,217,37,180
2683,NonExistentProduct,Books,Academic,951.53,450,376,74
2684,Amy,Home & Garden,Decor,364.01,470,76,394
2685,Pamela,Electronics,Headphones,651.11,90,7,83
2686,Justin,Electronics,Headphones,660.05,186,42,144
2687,Katie,Books,Non-fiction,642.11,176,17,159
2688,Shawn,Electronics,Headphones,461.09,461,130,331
2689,Anthony,Books,Academic,693.39,78,52,26
2690,Robert,Electronics,Mobile,847.43,126,33,93
2691,Anthony,Books,Academic,693.39,220,63,157
2692,Amy,Home & Garden,Decor,99999.99,272,217,55
2693,Nathaniel,Electronics,Camera,652.35,71,3,68
2694,Shannon,InvalidCategory,Gardening Tools,68.01,263,236,27
2695,Michael,Toys,Dolls,46.23,404,134,270
2696,Michael,Toys,Dolls,46.23,173,11,162
2697,Elizabeth,Clothing,Shirt,840.19,81,7,74
2698,Shawn,Electronics,Headphones,461.09,483,250,233
2699,Fred,Books,Academic,951.53,205,165,40
2700,Nathaniel,Electronics,Camera,652.35,354,88,266
2701,Shannon,Home & Garden,Gardening Tools,68.01,142,28,114
2702,Martha,Books,Fiction,99999.99,422,345,77
2703,Robert,Electronics,Mobile,847.43,95,34,61
2704,NonExistentProduct,InvalidCategory,Non-fiction,642.11,191,96,95
2705,Nathaniel,Electronics,Camera,652.35,330,119,211
2706,Tammy,Home & Garden,Furniture,431.82,323,251,72
2707,Tammy,Home & Garden,Furniture,431.82,116,45,71
2708,Fred,Books,Academic,951.53,216,206,10
2709,Michael,Toys,Dolls,46.23,218,35,183
2710,Shawn,Electronics,Headphones,InvalidPrice,281,193,88
2711,Kristine,Electronics,Headphones,22882.0,225,165,60
2712,NonExistentProduct,Clothing,Shirt,995.13,489,362,127
2713,Shawn,Electronics,Headphones,461.09,478,362,116
2714,Michael,Toys,Dolls,4623.0,256,151,105
2715,NonExistentProduct,Toys,Dolls,46.23,234,108,126
2716,Cynthia,Electronics,Headphones,0.01,337,251,86
2717,Martha,Books,Fiction,InvalidPrice,430,290,140
2718,NonExistentProduct,Toys,Dolls,99999.99,285,120,165
2719,Michael,Toys,Dolls,46.23,142,59,83
2720,NonExistentProduct,Books,Academic,99999.99,240,220,20
2721,Kristine,Electronics,Headphones,228.82,109,1,108
2722,NonExistentProduct,Home & Garden,Furniture,431.82,210,156,54
2723,Robert,Electronics,Mobile,847.43,401,188,213
2724,Amy,Home & Garden,Decor,364.01,297,18,279
2725,Michael,Toys,Dolls,46.23,77,22,55
2726,Michael,InvalidCategory,Dolls,46.23,96,53,43
2727,Robert,Electronics,Mobile,847.43,126,65,61
2728,Jamie,Books,Fiction,930.3,332,12,320
2729,Wanda,Toys,Educational,268.61,312,199,113
2730,Wanda,Toys,Educational,268.61,372,260,112
2731,Shannon,InvalidCategory,Gardening Tools,68.01,97,87,10
2732,Katie,Books,Non-fiction,642.11,67,36,31
2733,Fred,Books,Academic,951.53,217,130,87
2734,Anthony,Books,Academic,InvalidPrice,329,262,67
2735,Fred,Books,Academic,951.53,456,183,273
2736,NonExistentProduct,Clothing,Shirt,995.13,181,30,151
2737,Anthony,Books,Academic,693.39,347,227,120
2738,Nathaniel,Electronics,Camera,652.35,250,169,81
2739,Robert,Electronics,Mobile,847.43,430,226,204
2740,NonExistentProduct,Electronics,Camera,652.35,282,34,248
2741,Robert,Electronics,Mobile,847.43,358,232,126
2742,Elizabeth,Clothing,Shirt,99999.99,55,41,14
2743,Tammy,Home & Garden,Furniture,431.82,265,56,209
2744,Marvin,Clothing,Shirt,995.13,369,127,242
2745,Angela,Toys,Action Figures,0.01,212,151,61
2746,Wanda,Toys,Educational,InvalidPrice,269,74,195
2747,Tammy,Home & Garden,Furniture,431.82,436,229,207
2748,Amy,Home & Garden,Decor,364.01,204,80,124
2749,Marvin,InvalidCategory,Shirt,995.13,200,123,77
2750,Wanda,Toys,Educational,268.61,193,87,106
2751,Marvin,Clothing,Shirt,995.13,116,63,53
2752,Justin,Electronics,Headphones,99999.99,209,176,33
2753,Martha,Books,Fiction,0.01,241,22,219
2754,Nathaniel,Electronics,Camera,652.35,460,222,238
2755,Cynthia,Electronics,Headphones,872.85,297,70,227
2756,Shawn,Electronics,Headphones,461.09,264,251,13
2757,Robert,Electronics,Mobile,847.43,109,20,89
2758,Kristine,Electronics,Headphones,99999.99,195,100,95
2759,Marvin,Clothing,Shirt,995.13,400,212,188
2760,Shawn,Electronics,Headphones,461.09,462,283,179
2761,NonExistentProduct,Books,Fiction,433.1,406,67,339
2762,Justin,Electronics,Headphones,660.05,50,40,10
2763,NonExistentProduct,Home & Garden,Decor,364.01,130,11,119
2764,Robert,Electronics,Mobile,847.43,287,54,233
2765,Amy,Home & Garden,Decor,InvalidPrice,455,389,66
2766,Amy,InvalidCategory,Decor,InvalidPrice,353,235,118
2767,Justin,Electronics,Headphones,660.05,96,20,76
2768,Fred,Books,Academic,951.53,445,137,308
2769,Michael,Toys,Dolls,4623.0,430,176,254
2770,Elizabeth,Clothing,Shirt,840.19,170,133,37
2771,Angela,Toys,Action Figures,386.57,423,412,11
2772,NonExistentProduct,Home & Garden,Furniture,431.82,397,182,215
2773,Justin,Electronics,Headphones,660.05,220,20,200
2774,NonExistentProduct,Clothing,Shirt,840.19,407,110,297
2775,Shannon,Home & Garden,Gardening Tools,68.01,334,143,191
2776,Fred,Books,Academic,951.53,80,68,12
2777,Cynthia,Electronics,Headphones,InvalidPrice,111,64,47
2778,Shawn,Electronics,Headphones,461.09,404,131,273
2779,Nathaniel,Electronics,Camera,99999.99,84,30,54
2780,NonExistentProduct,Books,Fiction,930.3,454,284,170
2781,Tammy,Home & Garden,Furniture,InvalidPrice,469,36,433
2782,Wanda,Toys,Educational,26861.0,306,280,26
2783,Pamela,InvalidCategory,Headphones,651.11,66,19,47
2784,Kristine,Electronics,Headphones,99999.99,238,9,229
2785,Fred,Books,Academic,951.53,157,6,151
2786,Michael,Toys,Dolls,46.23,431,289,142
2787,Martha,Books,Fiction,433.1,256,167,89
2788,Shawn,Electronics,Headphones,461.09,239,92,147
2789,Jamie,Books,Fiction,930.3,235,75,160
2790,NonExistentProduct,Electronics,Headphones,99999.99,425,123,302
2791,Angela,Toys,Action Figures,38657.0,464,78,386
2792,Anthony,InvalidCategory,Academic,InvalidPrice,69,49,20
2793,Justin,Electronics,Headphones,InvalidPrice,200,93,107
2794,Robert,InvalidCategory,Mobile,847.43,387,238,149
2795,Justin,Electronics,Headphones,660.05,200,148,52
2796,Jamie,Books,Fiction,930.3,366,122,244
2797,Justin,Electronics,Headphones,660.05,107,38,69
2798,Angela,InvalidCategory,Action Figures,386.57,290,107,183
2799,Katie,Books,Non-fiction,642.11,105,28,77
2800,Katie,Books,Non-fiction,642.11,155,44,111
2801,Justin,Electronics,Headphones,660.05,219,41,178
2802,Pamela,Electronics,Headphones,651.11,480,159,321
2803,Tammy,Home & Garden,Furniture,431.82,156,6,150
2804,Kristine,Electronics,Headphones,InvalidPrice,272,11,261
2805,Angela,Toys,Action Figures,386.57,457,145,312
2806,Martha,Books,Fiction,433.1,336,313,23
2807,Marvin,Clothing,Shirt,995.13,64,12,52
2808,NonExistentProduct,Home & Garden,Gardening Tools,68.01,446,231,215
2809,Angela,Toys,Action Figures,99999.99,364,323,41
2810,Katie,Books,Non-fiction,642.11,85,27,58
2811,Pamela,Electronics,Headphones,651.11,165,162,3
2812,NonExistentProduct,Electronics,Headphones,660.05,269,228,41
2813,Pamela,Electronics,Headphones,651.11,220,219,1
2814,Martha,Books,Fiction,433.1,348,119,229
2815,Wanda,Toys,Educational,268.61,291,286,5
2816,Pamela,Electronics,Headphones,651.11,135,48,87
2817,Tammy,Home & Garden,Furniture,431.82,55,40,15
2818,Wanda,Toys,Educational,0.01,143,143,0
2819,Katie,Books,Non-fiction,64211.0,424,414,10
2820,Amy,Home & Garden,Decor,364.01,206,67,139
2821,Justin,Electronics,Headphones,660.05,427,397,30
2822,Pamela,Electronics,Headphones,651.11,155,136,19
2823,Katie,Books,Non-fiction,99999.99,359,82,277
2824,Jamie,Books,Fiction,930.3,344,166,178
2825,Jamie,Books,Fiction,930.3,344,334,10
2826,Cynthia,InvalidCategory,Headphones,872.85,96,20,76
2827,Elizabeth,Clothing,Shirt,0.01,75,59,16
2828,Shannon,Home & Garden,Gardening Tools,68.01,128,35,93
2829,Tammy,Home & Garden,Furniture,431.82,378,30,348
2830,Michael,Toys,Dolls,46.23,146,3,143
2831,Martha,Books,Fiction,433.1,64,60,4
2832,Marvin,Clothing,Shirt,995.13,247,202,45
2833,Shawn,Electronics,Headphones,461.09,276,127,149
2834,NonExistentProduct,Home & Garden,Gardening Tools,6801.000000000001,347,264,83
2835,Robert,InvalidCategory,Mobile,847.43,289,21,268
2836,Amy,Home & Garden,Decor,364.01,222,163,59
2837,Robert,Electronics,Mobile,InvalidPrice,389,241,148
2838,Marvin,InvalidCategory,Shirt,99513.0,284,123,161
2839,NonExistentProduct,Toys,Action Figures,386.57,373,82,291
2840,Katie,Books,Non-fiction,642.11,498,24,474
2841,Pamela,Electronics,Headphones,651.11,96,27,69
2842,Robert,Electronics,Mobile,InvalidPrice,278,221,57
2843,Anthony,Books,Academic,0.01,73,53,20
2844,Amy,Home & Garden,Decor,0.01,279,210,69
2845,Jamie,Books,Fiction,93030.0,450,216,234
2846,Wanda,Toys,Educational,99999.99,445,220,225
2847,NonExistentProduct,Electronics,Headphones,660.05,434,334,100
2848,Shannon,Home & Garden,Gardening Tools,68.01,206,109,97
2849,NonExistentProduct,Electronics,Mobile,847.43,110,35,75
2850,Robert,Electronics,Mobile,847.43,96,15,81
2851,Amy,Home & Garden,Decor,364.01,264,12,252
2852,NonExistentProduct,Electronics,Headphones,660.05,116,80,36
2853,Amy,Home & Garden,Decor,364.01,80,70,10
2854,NonExistentProduct,Books,Fiction,43310.0,152,97,55
2855,Pamela,Electronics,Headphones,651.11,86,18,68
2856,Pamela,Electronics,Headphones,651.11,89,49,40
2857,Robert,Electronics,Mobile,84743.0,175,38,137
2858,Nathaniel,Electronics,Camera,652.35,267,61,206
2859,Cynthia,Electronics,Headphones,872.85,270,88,182
2860,Tammy,Home & Garden,Furniture,431.82,144,139,5
2861,Marvin,Clothing,Shirt,995.13,265,123,142
2862,Shannon,Home & Garden,Gardening Tools,68.01,402,386,16
2863,Shannon,Home & Garden,Gardening Tools,68.01,482,341,141
2864,NonExistentProduct,Books,Fiction,433.1,277,14,263
2865,Shawn,Electronics,Headphones,0.01,419,241,178
2866,Tammy,Home & Garden,Furniture,0.01,180,1,179
2867,Kristine,Electronics,Headphones,228.82,100,7,93
2868,Jamie,Books,Fiction,93030.0,58,23,35
2869,Justin,Electronics,Headphones,660.05,161,56,105
2870,Martha,Books,Fiction,433.1,367,169,198
2871,Cynthia,Electronics,Headphones,872.85,494,122,372
2872,Nathaniel,Electronics,Camera,InvalidPrice,354,233,121
2873,Fred,Books,Academic,951.53,179,85,94
2874,Pamela,Electronics,Headphones,651.11,380,61,319
2875,Pamela,Electronics,Headphones,InvalidPrice,143,56,87
2876,Nathaniel,Electronics,Camera,99999.99,428,255,173
2877,Anthony,InvalidCategory,Academic,693.39,258,142,116
2878,Cynthia,Electronics,Headphones,872.85,442,210,232
2879,Robert,Electronics,Mobile,847.43,255,89,166
2880,Jamie,Books,Fiction,930.3,83,16,67
2881,Cynthia,Electronics,Headphones,872.85,223,46,177
2882,Shannon,Home & Garden,Gardening Tools,68.01,95,43,52
2883,Pamela,InvalidCategory,Headphones,651.11,100,34,66
2884,Amy,Home & Garden,Decor,364.01,368,92,276
2885,Robert,Electronics,Mobile,847.43,272,180,92
2886,Cynthia,Electronics,Headphones,872.85,384,73,311
2887,Pamela,Electronics,Headphones,651.11,373,123,250
2888,Pamela,Electronics,Headphones,651.11,128,40,88
2889,Nathaniel,Electronics,Camera,652.35,457,136,321
2890,Justin,Electronics,Headphones,660.05,259,196,63
2891,Justin,Electronics,Headphones,660.05,63,38,25
2892,Marvin,Clothing,Shirt,995.13,84,5,79
2893,Michael,Toys,Dolls,46.23,290,122,168
2894,Tammy,Home & Garden,Furniture,431.82,232,87,145
2895,NonExistentProduct,Electronics,Headphones,InvalidPrice,393,228,165
2896,Justin,InvalidCategory,Headphones,660.05,164,59,105
2897,Angela,Toys,Action Figures,386.57,282,109,173
2898,Robert,Electronics,Mobile,84743.0,454,192,262
2899,Justin,Electronics,Headphones,660.05,449,97,352
2900,Katie,Books,Non-fiction,64211.0,493,485,8
2901,Marvin,Clothing,Shirt,995.13,259,229,30
2902,Angela,Toys,Action Figures,InvalidPrice,254,161,93
2903,Anthony,Books,Academic,99999.99,136,15,121
2904,Pamela,Electronics,Headphones,651.11,323,71,252
2905,NonExistentProduct,InvalidCategory,Fiction,99999.99,180,28,152
2906,Marvin,Clothing,Shirt,995.13,240,193,47
2907,Nathaniel,Electronics,Camera,652.35,90,9,81
2908,Tammy,InvalidCategory,Furniture,431.82,301,16,285
2909,Kristine,Electronics,Headphones,228.82,360,241,119
2910,Wanda,Toys,Educational,268.61,224,20,204
2911,NonExistentProduct,Clothing,Shirt,995.13,410,27,383
2912,Shannon,Home & Garden,Gardening Tools,99999.99,455,130,325
2913,NonExistentProduct,Toys,Dolls,46.23,93,26,67
2914,Katie,Books,Non-fiction,InvalidPrice,124,76,48
2915,Marvin,Clothing,Shirt,995.13,283,49,234
2916,Wanda,Toys,Educational,26861.0,278,109,169
2917,Fred,Books,Academic,951.53,213,15,198
2918,Martha,Books,Fiction,433.1,235,25,210
2919,Shannon,Home & Garden,Gardening Tools,68.01,206,126,80
2920,Anthony,Books,Academic,69339.0,363,353,10
2921,Cynthia,Electronics,Headphones,872.85,207,165,42
2922,Robert,Electronics,Mobile,847.43,417,149,268
2923,Fred,Books,Academic,951.53,385,142,243
2924,Justin,Electronics,Headphones,660.05,492,19,473
2925,Robert,Electronics,Mobile,847.43,392,66,326
2926,Pamela,Electronics,Headphones,651.11,400,367,33
2927,Jamie,Books,Fiction,99999.99,476,151,325
2928,Amy,InvalidCategory,Decor,InvalidPrice,397,11,386
2929,NonExistentProduct,Books,Academic,951.53,440,293,147
2930,NonExistentProduct,Electronics,Headphones,228.82,440,358,82
2931,Wanda,Toys,Educational,268.61,329,123,206
2932,Martha,Books,Fiction,InvalidPrice,329,50,279
2933,Tammy,Home & Garden,Furniture,431.82,160,150,10
2934,Shawn,Electronics,Headphones,461.09,381,331,50
2935,Tammy,Home & Garden,Furniture,431.82,407,76,331
2936,Elizabeth,Clothing,Shirt,840.19,142,49,93
2937,Tammy,Home & Garden,Furniture,431.82,210,150,60
2938,Justin,Electronics,Headphones,660.05,218,31,187
2939,Tammy,Home & Garden,Furniture,431.82,297,42,255
2940,Shawn,Electronics,Headphones,461.09,260,122,138
2941,NonExistentProduct,Toys,Action Figures,386.57,132,99,33
2942,Amy,Home & Garden,Decor,364.01,412,156,256
2943,Martha,Books,Fiction,433.1,118,42,76
2944,Marvin,Clothing,Shirt,0.01,209,187,22
2945,Robert,Electronics,Mobile,84743.0,206,110,96
2946,Martha,Books,Fiction,433.1,447,61,386
2947,Martha,Books,Fiction,433.1,420,266,154
2948,Justin,Electronics,Headphones,660.05,157,90,67
2949,Cynthia,Electronics,Headphones,872.85,229,165,64
2950,Amy,Home & Garden,Decor,36401.0,154,133,21
2951,Angela,Toys,Action Figures,386.57,247,198,49
2952,Amy,Home & Garden,Decor,364.01,205,77,128
2953,Cynthia,Electronics,Headphones,InvalidPrice,265,159,106
2954,Marvin,InvalidCategory,Shirt,InvalidPrice,236,159,77
2955,Fred,InvalidCategory,Academic,951.53,307,304,3
2956,Wanda,Toys,Educational,268.61,475,322,153
2957,Martha,Books,Fiction,433.1,300,205,95
2958,Marvin,Clothing,Shirt,99513.0,169,157,12
2959,Anthony,Books,Academic,693.39,313,87,226
2960,Martha,Books,Fiction,433.1,296,277,19
2961,Shawn,Electronics,Headphones,99999.99,357,185,172
2962,Shawn,Electronics,Headphones,461.09,160,38,122
2963,Nathaniel,Electronics,Camera,652.35,192,55,137
2964,Pamela,Electronics,Headphones,651.11,373,39,334
2965,Robert,Electronics,Mobile,847.43,137,57,80
2966,Tammy,Home & Garden,Furniture,InvalidPrice,411,120,291
2967,Marvin,Clothing,Shirt,0.01,361,285,76
2968,Amy,Home & Garden,Decor,364.01,270,152,118
2969,Cynthia,Electronics,Headphones,87285.0,262,47,215
2970,Martha,Books,Fiction,433.1,53,1,52
2971,Amy,Home & Garden,Decor,364.01,78,44,34
2972,Jamie,Books,Fiction,InvalidPrice,58,31,27
2973,Jamie,Books,Fiction,930.3,146,96,50
2974,Martha,Books,Fiction,433.1,156,127,29
2975,Katie,Books,Non-fiction,642.11,447,233,214
2976,Martha,InvalidCategory,Fiction,43310.0,413,24,389
2977,Wanda,Toys,Educational,26861.0,341,208,133
2978,NonExistentProduct,Home & Garden,Furniture,InvalidPrice,200,54,146
2979,Michael,Toys,Dolls,46.23,462,427,35
2980,NonExistentProduct,Books,Academic,951.53,496,351,145
2981,Kristine,Electronics,Headphones,228.82,206,195,11
2982,Kristine,Electronics,Headphones,228.82,355,299,56
2983,Nathaniel,Electronics,Camera,652.35,426,288,138
2984,Robert,InvalidCategory,Mobile,847.43,158,81,77
2985,Anthony,Books,Academic,693.39,293,104,189
2986,Jamie,Books,Fiction,930.3,122,72,50
2987,Elizabeth,Clothing,Shirt,99999.99,357,243,114
2988,Jamie,Books,Fiction,0.01,107,94,13
2989,Tammy,InvalidCategory,Furniture,431.82,135,81,54
2990,Elizabeth,InvalidCategory,Shirt,840.19,481,439,42
2991,Martha,Books,Fiction,433.1,271,245,26
2992,Robert,Electronics,Mobile,99999.99,92,51,41
2993,Angela,Toys,Action Figures,386.57,78,59,19
2994,Anthony,Books,Academic,693.39,126,102,24
2995,Pamela,Electronics,Headphones,651.11,289,276,13
2996,Martha,Books,Fiction,99999.99,310,168,142
2997,Jamie,Books,Fiction,93030.0,195,61,134
2998,Robert,Electronics,Mobile,847.43,211,183,28
2999,Anthony,InvalidCategory,Academic,InvalidPrice,451,49,402
3000,Fred,Books,Academic,951.53,487,6,481
3001,Katie,InvalidCategory,Non-fiction,642.11,182,155,27
3002,Cynthia,InvalidCategory,Headphones,99999.99,395,312,83
3003,Tammy,Home & Garden,Furniture,99999.99,381,173,208
3004,Marvin,Clothing,Shirt,995.13,248,61,187
3005,Marvin,Clothing,Shirt,995.13,119,10,109
3006,Justin,Electronics,Headphones,660.05,244,136,108
3007,Jamie,Books,Fiction,930.3,465,404,61
3008,Fred,Books,Academic,99999.99,279,68,211
3009,Tammy,Home & Garden,Furniture,431.82,492,82,410
3010,Wanda,Toys,Educational,268.61,60,50,10
3011,Nathaniel,Electronics,Camera,652.35,187,8,179
3012,Martha,Books,Fiction,433.1,492,250,242
3013,Elizabeth,Clothing,Shirt,0.01,360,335,25
3014,Elizabeth,Clothing,Shirt,840.19,271,123,148
3015,Jamie,Books,Fiction,930.3,404,81,323
3016,Justin,InvalidCategory,Headphones,660.05,96,92,4
3017,Fred,Books,Academic,InvalidPrice,343,219,124
3018,Justin,Electronics,Headphones,99999.99,233,203,30
3019,Cynthia,Electronics,Headphones,872.85,349,293,56
3020,Tammy,Home & Garden,Furniture,InvalidPrice,99,68,31
3021,Tammy,Home & Garden,Furniture,431.82,339,49,290
3022,Jamie,Books,Fiction,930.3,195,182,13
3023,Martha,Books,Fiction,433.1,314,276,38
3024,Wanda,Toys,Educational,268.61,335,66,269
3025,Pamela,Electronics,Headphones,651.11,430,335,95
3026,NonExistentProduct,Books,Academic,InvalidPrice,126,119,7
3027,Robert,Electronics,Mobile,847.43,443,356,87
3028,Anthony,Books,Academic,99999.99,211,195,16
3029,Anthony,Books,Academic,693.39,444,344,100
3030,NonExistentProduct,Books,Fiction,433.1,213,4,209
3031,Anthony,Books,Academic,693.39,165,28,137
3032,Katie,Books,Non-fiction,64211.0,114,56,58
3033,Tammy,Home & Garden,Furniture,431.82,376,211,165
3034,Angela,Toys,Action Figures,0.01,186,21,165
3035,Elizabeth,Clothing,Shirt,840.19,474,53,421
3036,NonExistentProduct,Books,Fiction,930.3,209,49,160
3037,Wanda,Toys,Educational,0.01,219,174,45
3038,Michael,Toys,Dolls,46.23,104,89,15
3039,Fred,Books,Academic,99999.99,88,30,58
3040,Anthony,Books,Academic,69339.0,187,41,146
3041,Shawn,Electronics,Headphones,461.09,400,174,226
3042,Elizabeth,Clothing,Shirt,84019.0,233,95,138
3043,Kristine,Electronics,Headphones,InvalidPrice,429,256,173
3044,Jamie,Books,Fiction,0.01,86,70,16
3045,Cynthia,Electronics,Headphones,872.85,249,121,128
3046,Tammy,Home & Garden,Furniture,43182.0,186,35,151
3047,Tammy,InvalidCategory,Furniture,431.82,101,46,55
3048,Shannon,Home & Garden,Gardening Tools,6801.000000000001,267,191,76
3049,Anthony,Books,Academic,693.39,289,243,46
3050,Katie,Books,Non-fiction,64211.0,190,152,38
3051,NonExistentProduct,Books,Academic,951.53,160,18,142
3052,Elizabeth,Clothing,Shirt,840.19,404,181,223
3053,Kristine,Electronics,Headphones,0.01,473,259,214
3054,Cynthia,Electronics,Headphones,872.85,303,271,32
3055,Michael,Toys,Dolls,46.23,416,269,147
3056,Wanda,Toys,Educational,268.61,288,265,23
3057,Justin,InvalidCategory,Headphones,660.05,308,38,270
3058,Wanda,Toys,Educational,268.61,168,73,95
3059,Cynthia,Electronics,Headphones,872.85,454,93,361
3060,Shannon,Home & Garden,Gardening Tools,6801.000000000001,475,386,89
3061,Elizabeth,Clothing,Shirt,840.19,234,3,231
3062,Kristine,Electronics,Headphones,228.82,90,47,43
3063,Pamela,Electronics,Headphones,651.11,210,11,199
3064,Marvin,Clothing,Shirt,995.13,346,44,302
3065,Marvin,Clothing,Shirt,InvalidPrice,487,89,398
3066,Elizabeth,Clothing,Shirt,840.19,124,11,113
3067,Shannon,Home & Garden,Gardening Tools,68.01,316,37,279
3068,Martha,Books,Fiction,99999.99,271,100,171
3069,Wanda,Toys,Educational,99999.99,436,51,385
3070,Wanda,Toys,Educational,268.61,461,101,360
3071,Nathaniel,Electronics,Camera,652.35,62,36,26
3072,Fred,InvalidCategory,Academic,951.53,494,358,136
3073,Robert,Electronics,Mobile,847.43,143,68,75
3074,Robert,Electronics,Mobile,InvalidPrice,166,53,113
3075,NonExistentProduct,Electronics,Headphones,461.09,51,41,10
3076,Amy,Home & Garden,Decor,364.01,445,211,234
3077,Wanda,Toys,Educational,268.61,395,293,102
3078,Cynthia,Electronics,Headphones,872.85,344,198,146
3079,Fred,Books,Academic,95153.0,187,17,170
3080,Tammy,Home & Garden,Furniture,43182.0,255,146,109
3081,Angela,Toys,Action Figures,386.57,365,55,310
3082,Jamie,Books,Fiction,930.3,488,482,6
3083,NonExistentProduct,Electronics,Headphones,651.11,421,61,360
3084,Nathaniel,Electronics,Camera,652.35,237,15,222
3085,Robert,Electronics,Mobile,847.43,93,56,37
3086,Robert,InvalidCategory,Mobile,847.43,234,43,191
3087,Fred,Books,Academic,951.53,235,110,125
3088,Elizabeth,Clothing,Shirt,840.19,426,12,414
3089,Martha,Books,Fiction,433.1,111,74,37
3090,Jamie,Books,Fiction,99999.99,481,279,202
3091,Wanda,Toys,Educational,26861.0,318,243,75
3092,Kristine,Electronics,Headphones,228.82,472,389,83
3093,Anthony,Books,Academic,693.39,440,243,197
3094,Shannon,Home & Garden,Gardening Tools,68.01,136,103,33
3095,Kristine,Electronics,Headphones,228.82,97,87,10
3096,Nathaniel,InvalidCategory,Camera,99999.99,261,33,228
3097,Martha,Books,Fiction,43310.0,95,22,73
3098,NonExistentProduct,Toys,Dolls,4623.0,445,271,174
3099,Jamie,Books,Fiction,99999.99,232,142,90
3100,Amy,Home & Garden,Decor,364.01,57,3,54
3101,Justin,Electronics,Headphones,660.05,197,5,192
3102,Elizabeth,Clothing,Shirt,InvalidPrice,420,216,204
3103,NonExistentProduct,Home & Garden,Gardening Tools,68.01,496,266,230
3104,Nathaniel,Electronics,Camera,652.35,429,404,25
3105,Wanda,Toys,Educational,0.01,327,34,293
3106,Shawn,Electronics,Headphones,461.09,211,73,138
3107,NonExistentProduct,Electronics,Camera,652.35,266,130,136
3108,Nathaniel,Electronics,Camera,65235.0,65,12,53
3109,Katie,Books,Non-fiction,99999.99,178,167,11
3110,Shawn,InvalidCategory,Headphones,99999.99,52,11,41
3111,Wanda,Toys,Educational,268.61,359,212,147
3112,Amy,Home & Garden,Decor,364.01,449,188,261
3113,Marvin,Clothing,Shirt,995.13,227,41,186
3114,NonExistentProduct,InvalidCategory,Headphones,InvalidPrice,250,100,150
3115,Wanda,Toys,Educational,268.61,409,184,225
3116,Marvin,Clothing,Shirt,995.13,205,18,187
3117,Shannon,Home & Garden,Gardening Tools,99999.99,387,307,80
3118,Amy,InvalidCategory,Decor,364.01,171,91,80
3119,Michael,Toys,Dolls,4623.0,360,329,31
3120,NonExistentProduct,Books,Fiction,433.1,100,35,65
3121,NonExistentProduct,Toys,Dolls,99999.99,482,425,57
3122,Katie,Books,Non-fiction,642.11,391,78,313
3123,Jamie,Books,Fiction,0.01,128,1,127
3124,Angela,Toys,Action Figures,386.57,422,78,344
3125,Pamela,Electronics,Headphones,651.11,461,396,65
3126,Shannon,Home & Garden,Gardening Tools,99999.99,201,118,83
3127,Katie,Books,Non-fiction,642.11,112,25,87
3128,Angela,Toys,Action Figures,386.57,353,155,198
3129,Pamela,Electronics,Headphones,65111.0,441,343,98
3130,Wanda,Toys,Educational,268.61,255,206,49
3131,NonExistentProduct,Books,Academic,99999.99,59,23,36
3132,Katie,Books,Non-fiction,642.11,344,281,63
3133,Jamie,Books,Fiction,930.3,471,166,305
3134,Justin,Electronics,Headphones,660.05,168,46,122
3135,Tammy,Home & Garden,Furniture,431.82,232,217,15
3136,Angela,Toys,Action Figures,386.57,375,320,55
3137,Shannon,Home & Garden,Gardening Tools,68.01,377,10,367
3138,Michael,Toys,Dolls,InvalidPrice,242,222,20
3139,Shawn,Electronics,Headphones,46109.0,75,20,55
3140,Kristine,Electronics,Headphones,228.82,195,54,141
3141,Anthony,InvalidCategory,Academic,693.39,444,246,198
3142,Robert,Electronics,Mobile,847.43,330,137,193
3143,Jamie,Books,Fiction,930.3,433,387,46
3144,Angela,Toys,Action Figures,386.57,397,317,80
3145,Shawn,Electronics,Headphones,46109.0,148,51,97
3146,Pamela,InvalidCategory,Headphones,651.11,369,312,57
3147,Martha,Books,Fiction,433.1,218,144,74
3148,Marvin,Clothing,Shirt,99513.0,109,2,107
3149,Anthony,Books,Academic,693.39,114,85,29
3150,Anthony,Books,Academic,693.39,205,200,5
3151,Pamela,Electronics,Headphones,651.11,292,93,199
3152,Fred,Books,Academic,951.53,196,11,185
3153,Robert,Electronics,Mobile,0.01,416,190,226
3154,Pamela,Electronics,Headphones,651.11,356,57,299
3155,Robert,Electronics,Mobile,847.43,174,39,135
3156,Tammy,Home & Garden,Furniture,431.82,267,237,30
3157,Fred,Books,Academic,951.53,178,24,154
3158,Shannon,Home & Garden,Gardening Tools,68.01,259,254,5
3159,Angela,InvalidCategory,Action Figures,386.57,499,69,430
3160,Pamela,Electronics,Headphones,InvalidPrice,218,53,165
3161,Anthony,Books,Academic,693.39,254,58,196
3162,NonExistentProduct,Electronics,Camera,InvalidPrice,296,168,128
3163,Michael,InvalidCategory,Dolls,46.23,116,109,7
3164,Anthony,Books,Academic,693.39,251,152,99
3165,Kristine,Electronics,Headphones,InvalidPrice,303,149,154
3166,Marvin,Clothing,Shirt,995.13,236,57,179
3167,Katie,Books,Non-fiction,642.11,103,7,96
3168,NonExistentProduct,Books,Fiction,433.1,305,259,46
3169,Wanda,Toys,Educational,268.61,358,9,349
3170,Marvin,Clothing,Shirt,InvalidPrice,263,21,242
3171,Nathaniel,Electronics,Camera,652.35,85,35,50
3172,Pamela,Electronics,Headphones,651.11,372,199,173
3173,Shannon,Home & Garden,Gardening Tools,68.01,341,92,249
3174,Shannon,InvalidCategory,Gardening Tools,68.01,119,6,113
3175,Anthony,InvalidCategory,Academic,693.39,66,9,57
3176,Marvin,Clothing,Shirt,995.13,399,116,283
3177,Wanda,Toys,Educational,268.61,95,59,36
3178,Nathaniel,Electronics,Camera,652.35,220,208,12
3179,Robert,Electronics,Mobile,847.43,363,339,24
3180,Wanda,Toys,Educational,InvalidPrice,120,69,51
3181,Amy,Home & Garden,Decor,InvalidPrice,397,103,294
3182,Martha,Books,Fiction,433.1,211,81,130
3183,Elizabeth,Clothing,Shirt,840.19,104,98,6
3184,Shawn,Electronics,Headphones,461.09,382,39,343
3185,Fred,Books,Academic,951.53,493,167,326
3186,Tammy,Home & Garden,Furniture,431.82,341,133,208
3187,Marvin,Clothing,Shirt,995.13,454,429,25
3188,Tammy,Home & Garden,Furniture,431.82,302,2,300
3189,NonExistentProduct,Electronics,Headphones,660.05,277,200,77
3190,Justin,Electronics,Headphones,660.05,300,124,176
3191,Pamela,Electronics,Headphones,651.11,236,39,197
3192,Michael,Toys,Dolls,0.01,159,16,143
3193,Marvin,Clothing,Shirt,995.13,440,42,398
3194,Robert,Electronics,Mobile,847.43,261,106,155
3195,Marvin,Clothing,Shirt,0.01,148,27,121
3196,Angela,Toys,Action Figures,386.57,457,377,80
3197,Katie,Books,Non-fiction,642.11,343,94,249
3198,Michael,Toys,Dolls,46.23,406,2,404
3199,Robert,InvalidCategory,Mobile,99999.99,472,308,164
3200,Kristine,Electronics,Headphones,228.82,217,120,97
3201,Fred,Books,Academic,951.53,267,146,121
3202,Katie,Books,Non-fiction,642.11,345,245,100
3203,Katie,InvalidCategory,Non-fiction,642.11,400,155,245
3204,NonExistentProduct,Toys,Dolls,46.23,435,37,398
3205,Elizabeth,Clothing,Shirt,840.19,229,160,69
3206,Shannon,Home & Garden,Gardening Tools,68.01,181,162,19
3207,Nathaniel,Electronics,Camera,652.35,211,192,19
3208,Martha,Books,Fiction,433.1,136,22,114
3209,Anthony,Books,Academic,693.39,144,28,116
3210,Amy,Home & Garden,Decor,364.01,62,14,48
3211,Jamie,Books,Fiction,930.3,171,131,40
3212,Nathaniel,Electronics,Camera,99999.99,209,190,19
3213,NonExistentProduct,Electronics,Headphones,0.01,368,103,265
3214,Kristine,Electronics,Headphones,0.01,130,30,100
3215,Shannon,Home & Garden,Gardening Tools,68.01,307,220,87
3216,Tammy,Home & Garden,Furniture,InvalidPrice,448,285,163
3217,Pamela,InvalidCategory,Headphones,651.11,184,67,117
3218,Martha,InvalidCategory,Fiction,433.1,138,29,109
3219,Michael,Toys,Dolls,46.23,167,162,5
3220,Jamie,Books,Fiction,930.3,430,408,22
3221,Shannon,Home & Garden,Gardening Tools,68.01,202,50,152
3222,Marvin,Clothing,Shirt,InvalidPrice,264,163,101
3223,Fred,Books,Academic,951.53,118,24,94
3224,NonExistentProduct,InvalidCategory,Shirt,99513.0,414,66,348
3225,NonExistentProduct,Books,Academic,951.53,488,485,3
3226,Angela,Toys,Action Figures,386.57,244,189,55
3227,Amy,Home & Garden,Decor,364.01,324,179,145
3228,Robert,Electronics,Mobile,847.43,369,35,334
3229,Shannon,Home & Garden,Gardening Tools,68.01,484,359,125
3230,Amy,Home & Garden,Decor,364.01,243,212,31
3231,Michael,InvalidCategory,Dolls,46.23,479,201,278
3232,Fred,Books,Academic,951.53,235,23,212
3233,Shawn,Electronics,Headphones,461.09,194,141,53
3234,Wanda,Toys,Educational,99999.99,447,258,189
3235,Angela,Toys,Action Figures,386.57,64,37,27
3236,Elizabeth,Clothing,Shirt,840.19,293,32,261
3237,Anthony,Books,Academic,693.39,334,23,311
3238,Marvin,Clothing,Shirt,99513.0,496,336,160
3239,Katie,InvalidCategory,Non-fiction,642.11,302,189,113
3240,Cynthia,Electronics,Headphones,872.85,422,108,314
3241,Katie,Books,Non-fiction,642.11,228,52,176
3242,Katie,Books,Non-fiction,642.11,198,138,60
3243,Pamela,Electronics,Headphones,InvalidPrice,244,57,187
3244,Wanda,Toys,Educational,InvalidPrice,270,104,166
3245,Anthony,Books,Academic,69339.0,408,139,269
3246,Michael,Toys,Dolls,46.23,386,20,366
3247,Anthony,Books,Academic,693.39,88,86,2
3248,Kristine,InvalidCategory,Headphones,228.82,147,100,47
3249,Shawn,Electronics,Headphones,461.09,302,50,252
3250,Amy,Home & Garden,Decor,364.01,199,41,158
3251,Anthony,Books,Academic,693.39,236,152,84
3252,Angela,Toys,Action Figures,386.57,102,87,15
3253,Elizabeth,Clothing,Shirt,840.19,335,42,293
3254,Justin,Electronics,Headphones,660.05,180,101,79
3255,NonExistentProduct,Toys,Educational,268.61,196,29,167
3256,NonExistentProduct,Electronics,Headphones,228.82,401,159,242
3257,Cynthia,Electronics,Headphones,InvalidPrice,219,48,171
3258,Katie,Books,Non-fiction,642.11,355,212,143
3259,Amy,Home & Garden,Decor,364.01,188,151,37
3260,Martha,Books,Fiction,433.1,272,119,153
3261,NonExistentProduct,InvalidCategory,Educational,268.61,423,412,11
3262,Wanda,Toys,Educational,268.61,344,198,146
3263,Tammy,Home & Garden,Furniture,0.01,92,82,10
3264,Michael,Toys,Dolls,46.23,496,429,67
3265,Nathaniel,Electronics,Camera,65235.0,372,327,45
3266,Nathaniel,Electronics,Camera,652.35,257,126,131
3267,NonExistentProduct,Books,Non-fiction,64211.0,406,163,243
3268,Shawn,Electronics,Headphones,99999.99,57,39,18
3269,Anthony,Books,Academic,693.39,444,12,432
3270,Shannon,Home & Garden,Gardening Tools,68.01,354,142,212
3271,Shannon,Home & Garden,Gardening Tools,68.01,137,10,127
3272,Tammy,Home & Garden,Furniture,431.82,257,61,196
3273,Katie,Books,Non-fiction,642.11,117,28,89
3274,Kristine,InvalidCategory,Headphones,228.82,293,111,182
3275,Shawn,Electronics,Headphones,461.09,335,245,90
3276,Elizabeth,Clothing,Shirt,99999.99,488,254,234
3277,Nathaniel,Electronics,Camera,652.35,170,101,69
3278,NonExistentProduct,Home & Garden,Furniture,InvalidPrice,104,103,1
3279,Amy,InvalidCategory,Decor,364.01,241,203,38
3280,Robert,Electronics,Mobile,847.43,486,159,327
3281,Justin,Electronics,Headphones,660.05,392,290,102
3282,Shawn,Electronics,Headphones,461.09,151,101,50
3283,Wanda,Toys,Educational,268.61,115,60,55
3284,Angela,Toys,Action Figures,386.57,453,371,82
3285,Anthony,Books,Academic,693.39,217,28,189
3286,Tammy,Home & Garden,Furniture,431.82,212,101,111
3287,Shawn,Electronics,Headphones,0.01,500,260,240
3288,Robert,Electronics,Mobile,InvalidPrice,391,306,85
3289,Marvin,Clothing,Shirt,995.13,165,114,51
3290,Anthony,Books,Academic,693.39,366,109,257
3291,NonExistentProduct,Books,Fiction,433.1,136,86,50
3292,Elizabeth,Clothing,Shirt,InvalidPrice,208,117,91
3293,Pamela,Electronics,Headphones,651.11,80,64,16
3294,Fred,Books,Academic,95153.0,487,281,206
3295,Tammy,InvalidCategory,Furniture,431.82,288,23,265
3296,Shannon,Home & Garden,Gardening Tools,68.01,404,40,364
3297,Shannon,Home & Garden,Gardening Tools,68.01,291,195,96
3298,Amy,Home & Garden,Decor,36401.0,453,56,397
3299,Katie,Books,Non-fiction,64211.0,193,34,159
3300,Wanda,Toys,Educational,268.61,482,214,268
3301,Tammy,Home & Garden,Furniture,InvalidPrice,77,11,66
3302,Justin,Electronics,Headphones,660.05,207,55,152
3303,Elizabeth,InvalidCategory,Shirt,840.19,268,202,66
3304,Amy,Home & Garden,Decor,364.01,386,325,61
3305,Michael,Toys,Dolls,46.23,71,27,44
3306,Amy,Home & Garden,Decor,364.01,447,307,140
3307,Michael,Toys,Dolls,46.23,135,63,72
3308,Robert,Electronics,Mobile,84743.0,378,157,221
3309,Angela,Toys,Action Figures,386.57,403,353,50
3310,Jamie,Books,Fiction,930.3,347,289,58
3311,Nathaniel,InvalidCategory,Camera,65235.0,328,168,160
3312,Shannon,Home & Garden,Gardening Tools,68.01,93,68,25
3313,Angela,Toys,Action Figures,386.57,450,292,158
3314,Nathaniel,Electronics,Camera,652.35,447,230,217
3315,Tammy,Home & Garden,Furniture,431.82,279,17,262
3316,Martha,Books,Fiction,433.1,235,90,145
3317,Wanda,Toys,Educational,268.61,56,39,17
3318,Cynthia,InvalidCategory,Headphones,872.85,416,80,336
3319,Elizabeth,Clothing,Shirt,840.19,247,244,3
3320,Nathaniel,Electronics,Camera,652.35,234,41,193
3321,Robert,Electronics,Mobile,84743.0,231,168,63
3322,Michael,Toys,Dolls,InvalidPrice,104,38,66
3323,Wanda,Toys,Educational,268.61,399,164,235
3324,Michael,Toys,Dolls,InvalidPrice,290,219,71
3325,Shawn,Electronics,Headphones,461.09,443,220,223
3326,NonExistentProduct,Books,Academic,69339.0,395,229,166
3327,Cynthia,Electronics,Headphones,0.01,76,12,64
3328,Elizabeth,Clothing,Shirt,840.19,451,135,316
3329,Kristine,Electronics,Headphones,228.82,437,40,397
3330,Anthony,Books,Academic,693.39,89,42,47
3331,Nathaniel,Electronics,Camera,652.35,93,64,29
3332,NonExistentProduct,Toys,Dolls,46.23,224,171,53
3333,Shawn,Electronics,Headphones,461.09,148,12,136
3334,Cynthia,Electronics,Headphones,872.85,119,23,96
3335,Justin,Electronics,Headphones,660.05,387,365,22
3336,Michael,Toys,Dolls,46.23,185,27,158
3337,Justin,Electronics,Headphones,InvalidPrice,483,435,48
3338,Cynthia,Electronics,Headphones,872.85,328,328,0
3339,NonExistentProduct,Electronics,Camera,652.35,487,32,455
3340,Kristine,Electronics,Headphones,228.82,344,214,130
3341,Martha,Books,Fiction,433.1,319,19,300
3342,Fred,Books,Academic,951.53,260,116,144
3343,Justin,Electronics,Headphones,660.05,213,90,123
3344,Katie,Books,Non-fiction,642.11,413,128,285
3345,Anthony,Books,Academic,693.39,317,199,118
3346,Robert,Electronics,Mobile,847.43,101,14,87
3347,Nathaniel,Electronics,Camera,99999.99,233,171,62
3348,Fred,Books,Academic,951.53,421,378,43
3349,Wanda,Toys,Educational,0.01,335,60,275
3350,Justin,Electronics,Headphones,660.05,396,246,150
3351,Wanda,Toys,Educational,268.61,468,410,58
3352,Tammy,Home & Garden,Furniture,431.82,110,12,98
3353,Shannon,Home & Garden,Gardening Tools,68.01,451,287,164
3354,NonExistentProduct,Electronics,Mobile,847.43,139,136,3
3355,Kristine,Electronics,Headphones,228.82,232,126,106
3356,Shawn,Electronics,Headphones,461.09,275,12,263
3357,Marvin,Clothing,Shirt,995.13,467,144,323
3358,Nathaniel,Electronics,Camera,652.35,495,306,189
3359,Robert,Electronics,Mobile,847.43,67,67,0
3360,Shannon,Home & Garden,Gardening Tools,68.01,95,93,2
3361,Wanda,Toys,Educational,268.61,189,120,69
3362,Tammy,Home & Garden,Furniture,431.82,409,77,332
3363,Pamela,Electronics,Headphones,InvalidPrice,124,116,8
3364,Justin,Electronics,Headphones,660.05,278,79,199
3365,Marvin,Clothing,Shirt,995.13,429,184,245
3366,Kristine,Electronics,Headphones,228.82,333,244,89
3367,Fred,Books,Academic,951.53,84,58,26
3368,Martha,Books,Fiction,433.1,108,49,59
3369,Tammy,Home & Garden,Furniture,InvalidPrice,458,367,91
3370,NonExistentProduct,Electronics,Camera,652.35,97,84,13
3371,NonExistentProduct,Electronics,Headphones,660.05,347,77,270
3372,Nathaniel,Electronics,Camera,652.35,466,325,141
3373,Michael,Toys,Dolls,4623.0,295,61,234
3374,Amy,Home & Garden,Decor,364.01,154,103,51
3375,Amy,Home & Garden,Decor,364.01,263,180,83
3376,Anthony,Books,Academic,693.39,437,67,370
3377,NonExistentProduct,InvalidCategory,Mobile,0.01,465,78,387
3378,Anthony,Books,Academic,693.39,205,48,157
3379,Marvin,Clothing,Shirt,995.13,384,189,195
3380,Nathaniel,Electronics,Camera,652.35,237,89,148
3381,Pamela,Electronics,Headphones,0.01,127,17,110
3382,Kristine,Electronics,Headphones,0.01,429,427,2
3383,Shawn,Electronics,Headphones,461.09,248,186,62
3384,Tammy,Home & Garden,Furniture,InvalidPrice,201,88,113
3385,Cynthia,Electronics,Headphones,872.85,346,279,67
3386,Angela,Toys,Action Figures,386.57,394,285,109
3387,Pamela,Electronics,Headphones,651.11,422,375,47
3388,NonExistentProduct,Home & Garden,Furniture,43182.0,405,19,386
3389,Angela,Toys,Action Figures,386.57,81,65,16
3390,Kristine,InvalidCategory,Headphones,InvalidPrice,273,126,147
3391,Robert,Electronics,Mobile,847.43,105,78,27
3392,Tammy,Home & Garden,Furniture,0.01,190,100,90
3393,Jamie,Books,Fiction,930.3,144,22,122
3394,Jamie,Books,Fiction,InvalidPrice,255,30,225
3395,Fred,Books,Academic,95153.0,408,274,134
3396,Shannon,Home & Garden,Gardening Tools,6801.000000000001,61,42,19
3397,Shawn,Electronics,Headphones,461.09,86,84,2
3398,Amy,InvalidCategory,Decor,36401.0,304,239,65
3399,Marvin,Clothing,Shirt,99513.0,298,220,78
3400,Angela,Toys,Action Figures,386.57,71,71,0
3401,Nathaniel,Electronics,Camera,0.01,185,68,117
3402,Marvin,Clothing,Shirt,995.13,423,127,296
3403,Shannon,InvalidCategory,Gardening Tools,68.01,157,12,145
3404,Wanda,Toys,Educational,268.61,330,316,14
3405,Nathaniel,Electronics,Camera,652.35,185,17,168
3406,Elizabeth,Clothing,Shirt,840.19,108,21,87
3407,Katie,Books,Non-fiction,642.11,449,201,248
3408,Katie,Books,Non-fiction,642.11,396,104,292
3409,Marvin,Clothing,Shirt,InvalidPrice,406,387,19
3410,Michael,Toys,Dolls,46.23,271,251,20
3411,Cynthia,Electronics,Headphones,872.85,273,20,253
3412,Cynthia,Electronics,Headphones,872.85,458,21,437
3413,Justin,Electronics,Headphones,660.05,170,103,67
3414,Martha,Books,Fiction,InvalidPrice,432,118,314
3415,Fred,Books,Academic,951.53,350,94,256
3416,Pamela,Electronics,Headphones,651.11,415,208,207
3417,Wanda,Toys,Educational,268.61,143,16,127
3418,Justin,Electronics,Headphones,660.05,354,207,147
3419,Katie,InvalidCategory,Non-fiction,642.11,195,105,90
3420,Katie,InvalidCategory,Non-fiction,642.11,453,68,385
3421,Shannon,Home & Garden,Gardening Tools,68.01,392,209,183
3422,Martha,InvalidCategory,Fiction,433.1,464,464,0
3423,Shannon,Home & Garden,Gardening Tools,68.01,282,80,202
3424,Marvin,Clothing,Shirt,995.13,476,18,458
3425,Kristine,Electronics,Headphones,228.82,244,144,100
3426,Shannon,Home & Garden,Gardening Tools,InvalidPrice,373,39,334
3427,Tammy,Home & Garden,Furniture,431.82,348,31,317
3428,Nathaniel,Electronics,Camera,652.35,241,105,136
3429,Cynthia,Electronics,Headphones,InvalidPrice,305,118,187
3430,Marvin,Clothing,Shirt,995.13,166,17,149
3431,Marvin,Clothing,Shirt,995.13,407,343,64
3432,Tammy,Home & Garden,Furniture,43182.0,218,8,210
3433,Nathaniel,Electronics,Camera,652.35,72,55,17
3434,Anthony,Books,Academic,693.39,484,85,399
3435,Elizabeth,InvalidCategory,Shirt,840.19,276,33,243
3436,Kristine,Electronics,Headphones,228.82,394,74,320
3437,Fred,Books,Academic,951.53,411,111,300
3438,Marvin,Clothing,Shirt,99999.99,76,14,62
3439,Wanda,Toys,Educational,26861.0,207,201,6
3440,Amy,Home & Garden,Decor,364.01,346,5,341
3441,Anthony,Books,Academic,693.39,279,142,137
3442,Justin,Electronics,Headphones,99999.99,54,27,27
3443,Marvin,Clothing,Shirt,995.13,180,180,0
3444,Cynthia,Electronics,Headphones,87285.0,258,132,126
3445,Justin,Electronics,Headphones,660.05,185,161,24
3446,Tammy,InvalidCategory,Furniture,431.82,396,328,68
3447,Amy,Home & Garden,Decor,0.01,149,18,131
3448,NonExistentProduct,Home & Garden,Decor,364.01,150,100,50
3449,Fred,Books,Academic,951.53,333,103,230
3450,NonExistentProduct,Toys,Educational,268.61,202,58,144
3451,Marvin,Clothing,Shirt,0.01,118,31,87
3452,Tammy,Home & Garden,Furniture,431.82,75,42,33
3453,Shannon,InvalidCategory,Gardening Tools,68.01,442,129,313
3454,Pamela,Electronics,Headphones,651.11,450,204,246
3455,Angela,Toys,Action Figures,386.57,122,59,63
3456,Anthony,Books,Academic,693.39,386,165,221
3457,NonExistentProduct,Home & Garden,Gardening Tools,0.01,315,217,98
3458,Shannon,Home & Garden,Gardening Tools,68.01,283,259,24
3459,Shannon,InvalidCategory,Gardening Tools,68.01,68,6,62
3460,NonExistentProduct,Clothing,Shirt,840.19,258,124,134
3461,Tammy,Home & Garden,Furniture,431.82,70,17,53
3462,Martha,Books,Fiction,InvalidPrice,136,90,46
3463,Pamela,Electronics,Headphones,651.11,415,279,136
3464,Marvin,Clothing,Shirt,995.13,375,262,113
3465,Katie,Books,Non-fiction,99999.99,488,374,114
3466,Nathaniel,Electronics,Camera,InvalidPrice,499,216,283
3467,Robert,Electronics,Mobile,847.43,395,276,119
3468,Jamie,Books,Fiction,99999.99,305,287,18
3469,Elizabeth,Clothing,Shirt,84019.0,259,35,224
3470,Cynthia,Electronics,Headphones,InvalidPrice,500,298,202
3471,Elizabeth,Clothing,Shirt,840.19,349,249,100
3472,Michael,Toys,Dolls,46.23,430,183,247
3473,Amy,Home & Garden,Decor,364.01,359,16,343
3474,NonExistentProduct,Toys,Dolls,0.01,164,106,58
3475,Nathaniel,Electronics,Camera,652.35,126,74,52
3476,Katie,Books,Non-fiction,99999.99,99,65,34
3477,Marvin,Clothing,Shirt,995.13,447,69,378
3478,Fred,Books,Academic,951.53,171,46,125
3479,Amy,Home & Garden,Decor,364.01,306,116,190
3480,NonExistentProduct,InvalidCategory,Academic,951.53,280,246,34
3481,Robert,Electronics,Mobile,84743.0,62,42,20
3482,Nathaniel,Electronics,Camera,InvalidPrice,490,147,343
3483,Katie,Books,Non-fiction,642.11,367,313,54
3484,Shannon,Home & Garden,Gardening Tools,68.01,465,357,108
3485,Shawn,Electronics,Headphones,InvalidPrice,212,196,16
3486,Fred,Books,Academic,951.53,236,233,3
3487,Shannon,Home & Garden,Gardening Tools,68.01,406,156,250
3488,Anthony,Books,Academic,693.39,379,234,145
3489,Wanda,Toys,Educational,268.61,110,63,47
3490,Katie,Books,Non-fiction,642.11,193,84,109
3491,Tammy,Home & Garden,Furniture,99999.99,257,181,76
3492,Kristine,InvalidCategory,Headphones,99999.99,175,55,120
3493,Cynthia,Electronics,Headphones,872.85,369,165,204
3494,Kristine,Electronics,Headphones,228.82,81,16,65
3495,Cynthia,InvalidCategory,Headphones,872.85,477,130,347
3496,NonExistentProduct,InvalidCategory,Furniture,431.82,96,27,69
3497,Wanda,Toys,Educational,268.61,223,22,201
3498,Nathaniel,Electronics,Camera,65235.0,220,198,22
3499,Nathaniel,Electronics,Camera,652.35,76,38,38
3500,NonExistentProduct,Toys,Dolls,46.23,280,33,247
3501,Cynthia,Electronics,Headphones,872.85,433,363,70
3502,Fred,Books,Academic,951.53,359,68,291
3503,Tammy,Home & Garden,Furniture,431.82,152,74,78
3504,Kristine,Electronics,Headphones,228.82,472,404,68
3505,NonExistentProduct,Books,Academic,693.39,204,191,13
3506,Michael,Toys,Dolls,46.23,265,121,144
3507,Kristine,InvalidCategory,Headphones,228.82,149,1,148
3508,Justin,Electronics,Headphones,660.05,142,103,39
3509,Martha,Books,Fiction,433.1,494,290,204
3510,Fred,Books,Academic,951.53,426,186,240
3511,Kristine,Electronics,Headphones,228.82,326,63,263
3512,NonExistentProduct,Electronics,Mobile,847.43,422,304,118
3513,Cynthia,Electronics,Headphones,872.85,66,50,16
3514,Fred,Books,Academic,951.53,345,75,270
3515,Shawn,Electronics,Headphones,461.09,443,74,369
3516,Robert,Electronics,Mobile,847.43,493,224,269
3517,Robert,InvalidCategory,Mobile,InvalidPrice,54,20,34
3518,Marvin,Clothing,Shirt,99513.0,85,24,61
3519,Pamela,Electronics,Headphones,651.11,439,129,310
3520,Wanda,Toys,Educational,268.61,266,204,62
3521,Jamie,Books,Fiction,930.3,143,45,98
3522,Angela,Toys,Action Figures,386.57,321,233,88
3523,NonExistentProduct,Toys,Educational,268.61,372,146,226
3524,Fred,Books,Academic,951.53,408,370,38
3525,Michael,Toys,Dolls,InvalidPrice,68,4,64
3526,Marvin,InvalidCategory,Shirt,995.13,272,38,234
3527,NonExistentProduct,Electronics,Headphones,0.01,274,98,176
3528,Tammy,Home & Garden,Furniture,431.82,478,145,333
3529,Michael,Toys,Dolls,46.23,247,152,95
3530,Angela,InvalidCategory,Action Figures,386.57,141,128,13
3531,Cynthia,InvalidCategory,Headphones,872.85,291,220,71
3532,Wanda,Toys,Educational,26861.0,361,136,225
3533,Shawn,Electronics,Headphones,InvalidPrice,51,49,2
3534,NonExistentProduct,Electronics,Headphones,228.82,214,189,25
3535,Michael,Toys,Dolls,46.23,204,85,119
3536,Wanda,Toys,Educational,268.61,144,62,82
3537,Pamela,Electronics,Headphones,651.11,171,165,6
3538,Martha,Books,Fiction,433.1,167,18,149
3539,Michael,Toys,Dolls,46.23,116,92,24
3540,Pamela,Electronics,Headphones,651.11,176,176,0
3541,Anthony,Books,Academic,693.39,55,35,20
3542,Robert,Electronics,Mobile,847.43,184,50,134
3543,NonExistentProduct,Electronics,Headphones,66005.0,389,56,333
3544,Angela,Toys,Action Figures,386.57,250,161,89
3545,Pamela,Electronics,Headphones,0.01,464,237,227
3546,Robert,Electronics,Mobile,847.43,107,26,81
3547,Shawn,Electronics,Headphones,461.09,107,32,75
3548,Robert,Electronics,Mobile,847.43,313,45,268
3549,Robert,Electronics,Mobile,99999.99,279,40,239
3550,Shawn,Electronics,Headphones,461.09,433,79,354
3551,Elizabeth,Clothing,Shirt,840.19,333,158,175
3552,Nathaniel,Electronics,Camera,652.35,356,350,6
3553,Fred,Books,Academic,951.53,344,259,85
3554,Martha,Books,Fiction,433.1,369,368,1
3555,Wanda,Toys,Educational,InvalidPrice,300,224,76
3556,Robert,Electronics,Mobile,847.43,405,384,21
3557,Robert,Electronics,Mobile,847.43,84,51,33
3558,Marvin,Clothing,Shirt,99513.0,75,25,50
3559,Michael,Toys,Dolls,46.23,461,58,403
3560,Cynthia,Electronics,Headphones,872.85,313,259,54
3561,Pamela,Electronics,Headphones,651.11,234,229,5
3562,Amy,Home & Garden,Decor,364.01,269,250,19
3563,Katie,Books,Non-fiction,642.11,246,124,122
3564,Wanda,Toys,Educational,InvalidPrice,190,12,178
3565,Elizabeth,Clothing,Shirt,840.19,309,101,208
3566,Shannon,InvalidCategory,Gardening Tools,68.01,468,103,365
3567,Wanda,Toys,Educational,0.01,233,162,71
3568,Pamela,Electronics,Headphones,651.11,497,339,158
3569,Wanda,Toys,Educational,0.01,244,220,24
3570,Pamela,Electronics,Headphones,651.11,335,314,21
3571,Michael,Toys,Dolls,46.23,321,8,313
3572,Kristine,Electronics,Headphones,0.01,74,52,22
3573,Robert,Electronics,Mobile,847.43,111,33,78
3574,Martha,Books,Fiction,433.1,198,159,39
3575,Tammy,Home & Garden,Furniture,431.82,102,5,97
3576,Amy,Home & Garden,Decor,0.01,107,20,87
3577,Angela,Toys,Action Figures,386.57,489,310,179
3578,Wanda,Toys,Educational,26861.0,293,162,131
3579,Jamie,InvalidCategory,Fiction,930.3,269,119,150
3580,Amy,Home & Garden,Decor,364.01,180,34,146
3581,Cynthia,Electronics,Headphones,872.85,297,158,139
3582,Marvin,Clothing,Shirt,995.13,341,215,126
3583,Shawn,Electronics,Headphones,0.01,200,31,169
3584,Shannon,Home & Garden,Gardening Tools,68.01,244,211,33
3585,Shawn,Electronics,Headphones,461.09,318,78,240
3586,Shannon,Home & Garden,Gardening Tools,99999.99,342,298,44
3587,Shannon,Home & Garden,Gardening Tools,68.01,62,9,53
3588,Kristine,InvalidCategory,Headphones,228.82,56,9,47
3589,Cynthia,Electronics,Headphones,872.85,82,35,47
3590,Shawn,Electronics,Headphones,461.09,175,4,171
3591,Martha,Books,Fiction,433.1,396,273,123
3592,Shannon,Home & Garden,Gardening Tools,68.01,118,13,105
3593,Shannon,Home & Garden,Gardening Tools,6801.000000000001,462,427,35
3594,NonExistentProduct,Toys,Dolls,4623.0,83,22,61
3595,Robert,Electronics,Mobile,847.43,481,143,338
3596,Shannon,Home & Garden,Gardening Tools,68.01,187,52,135
3597,NonExistentProduct,Clothing,Shirt,995.13,294,42,252
3598,Anthony,Books,Academic,693.39,464,369,95
3599,Katie,Books,Non-fiction,InvalidPrice,369,11,358
3600,Katie,Books,Non-fiction,642.11,129,84,45
3601,Katie,Books,Non-fiction,642.11,266,57,209
3602,Justin,Electronics,Headphones,660.05,151,77,74
3603,Amy,Home & Garden,Decor,364.01,342,200,142
3604,Shawn,Electronics,Headphones,461.09,180,4,176
3605,Martha,Books,Fiction,InvalidPrice,431,279,152
3606,Fred,Books,Academic,951.53,430,161,269
3607,Tammy,Home & Garden,Furniture,431.82,154,13,141
3608,Robert,Electronics,Mobile,847.43,357,326,31
3609,Anthony,Books,Academic,InvalidPrice,464,32,432
3610,Angela,Toys,Action Figures,InvalidPrice,390,178,212
3611,Jamie,Books,Fiction,930.3,266,130,136
3612,Shannon,Home & Garden,Gardening Tools,0.01,446,339,107
3613,Kristine,Electronics,Headphones,228.82,344,232,112
3614,Nathaniel,Electronics,Camera,0.01,426,316,110
3615,Elizabeth,Clothing,Shirt,840.19,173,123,50
3616,Tammy,InvalidCategory,Furniture,431.82,423,132,291
3617,Robert,Electronics,Mobile,847.43,208,134,74
3618,Shannon,Home & Garden,Gardening Tools,68.01,249,165,84
3619,Elizabeth,InvalidCategory,Shirt,840.19,387,42,345
3620,Robert,Electronics,Mobile,99999.99,250,147,103
3621,Tammy,Home & Garden,Furniture,431.82,135,64,71
3622,Nathaniel,Electronics,Camera,652.35,107,98,9
3623,Tammy,Home & Garden,Furniture,431.82,222,218,4
3624,Marvin,InvalidCategory,Shirt,995.13,221,159,62
3625,Wanda,Toys,Educational,268.61,261,165,96
3626,Katie,Books,Non-fiction,99999.99,284,118,166
3627,Shannon,Home & Garden,Gardening Tools,68.01,80,72,8
3628,Elizabeth,InvalidCategory,Shirt,840.19,142,97,45
3629,Nathaniel,Electronics,Camera,0.01,431,300,131
3630,Angela,Toys,Action Figures,386.57,313,84,229
3631,Tammy,InvalidCategory,Furniture,431.82,456,57,399
3632,Elizabeth,Clothing,Shirt,840.19,393,56,337
3633,Robert,Electronics,Mobile,99999.99,79,28,51
3634,Katie,InvalidCategory,Non-fiction,642.11,96,11,85
3635,Pamela,Electronics,Headphones,651.11,98,61,37
3636,Wanda,Toys,Educational,268.61,75,68,7
3637,Katie,Books,Non-fiction,642.11,160,114,46
3638,Wanda,Toys,Educational,InvalidPrice,198,33,165
3639,Tammy,Home & Garden,Furniture,431.82,327,9,318
3640,NonExistentProduct,Clothing,Shirt,840.19,460,211,249
3641,Michael,Toys,Dolls,99999.99,277,18,259
3642,Justin,Electronics,Headphones,0.01,292,243,49
3643,Kristine,Electronics,Headphones,228.82,482,433,49
3644,Robert,InvalidCategory,Mobile,847.43,57,19,38
3645,Anthony,Books,Academic,693.39,271,85,186
3646,Robert,Electronics,Mobile,847.43,119,60,59
3647,NonExistentProduct,Toys,Action Figures,386.57,396,380,16
3648,Jamie,Books,Fiction,930.3,362,346,16
3649,Elizabeth,Clothing,Shirt,840.19,129,22,107
3650,NonExistentProduct,Home & Garden,Gardening Tools,68.01,473,417,56
3651,NonExistentProduct,Electronics,Headphones,228.82,268,214,54
3652,NonExistentProduct,Books,Academic,693.39,61,40,21
3653,Elizabeth,Clothing,Shirt,840.19,466,15,451
3654,Martha,InvalidCategory,Fiction,99999.99,379,332,47
3655,Tammy,Home & Garden,Furniture,0.01,205,12,193
3656,NonExistentProduct,Books,Non-fiction,642.11,473,278,195
3657,Wanda,Toys,Educational,26861.0,215,148,67
3658,Cynthia,Electronics,Headphones,872.85,183,133,50
3659,Wanda,InvalidCategory,Educational,268.61,246,126,120
3660,Shannon,Home & Garden,Gardening Tools,0.01,417,202,215
3661,Shannon,Home & Garden,Gardening Tools,68.01,204,188,16
3662,Fred,Books,Academic,InvalidPrice,178,85,93
3663,Fred,Books,Academic,951.53,75,54,21
3664,Fred,Books,Academic,InvalidPrice,445,208,237
3665,Justin,Electronics,Headphones,660.05,96,75,21
3666,Tammy,Home & Garden,Furniture,0.01,86,26,60
3667,Pamela,Electronics,Headphones,651.11,480,32,448
3668,Tammy,Home & Garden,Furniture,431.82,296,160,136
3669,Shawn,Electronics,Headphones,InvalidPrice,477,65,412
3670,Shannon,Home & Garden,Gardening Tools,99999.99,75,50,25
3671,Shannon,InvalidCategory,Gardening Tools,68.01,191,170,21
3672,Anthony,Books,Academic,693.39,133,91,42
3673,Marvin,Clothing,Shirt,995.13,267,225,42
3674,Marvin,Clothing,Shirt,995.13,99,17,82
3675,Shawn,Electronics,Headphones,46109.0,385,171,214
3676,Angela,Toys,Action Figures,386.57,256,91,165
3677,Elizabeth,Clothing,Shirt,840.19,277,175,102
3678,Amy,Home & Garden,Decor,364.01,69,14,55
3679,Tammy,Home & Garden,Furniture,431.82,382,46,336
3680,Fred,Books,Academic,951.53,499,190,309
3681,Justin,Electronics,Headphones,0.01,247,164,83
3682,Anthony,Books,Academic,693.39,496,40,456
3683,Justin,Electronics,Headphones,660.05,489,19,470
3684,Anthony,Books,Academic,693.39,432,239,193
3685,Cynthia,Electronics,Headphones,InvalidPrice,488,161,327
3686,Anthony,Books,Academic,69339.0,160,147,13
3687,Elizabeth,Clothing,Shirt,84019.0,292,9,283
3688,Shawn,InvalidCategory,Headphones,461.09,262,227,35
3689,Shannon,InvalidCategory,Gardening Tools,99999.99,436,275,161
3690,Tammy,Home & Garden,Furniture,431.82,425,226,199
3691,NonExistentProduct,Toys,Action Figures,386.57,194,27,167
3692,Shannon,InvalidCategory,Gardening Tools,0.01,302,177,125
3693,Shawn,InvalidCategory,Headphones,99999.99,377,255,122
3694,Angela,Toys,Action Figures,386.57,401,23,378
3695,Amy,Home & Garden,Decor,364.01,98,39,59
3696,Michael,Toys,Dolls,46.23,137,104,33
3697,Fred,Books,Academic,951.53,95,40,55
3698,Angela,Toys,Action Figures,386.57,325,269,56
3699,Robert,Electronics,Mobile,847.43,490,414,76
3700,Anthony,Books,Academic,693.39,147,56,91
3701,Fred,Books,Academic,951.53,425,298,127
3702,Marvin,Clothing,Shirt,995.13,430,67,363
3703,NonExistentProduct,Books,Academic,69339.0,431,312,119
3704,Wanda,Toys,Educational,268.61,157,57,100
3705,Pamela,Electronics,Headphones,0.01,443,63,380
3706,Amy,Home & Garden,Decor,364.01,69,26,43
3707,NonExistentProduct,Books,Non-fiction,64211.0,92,66,26
3708,Cynthia,Electronics,Headphones,0.01,329,28,301
3709,Katie,InvalidCategory,Non-fiction,64211.0,235,99,136
3710,Jamie,Books,Fiction,InvalidPrice,396,111,285
3711,Elizabeth,Clothing,Shirt,84019.0,187,134,53
3712,Nathaniel,InvalidCategory,Camera,652.35,370,62,308
3713,Michael,Toys,Dolls,46.23,409,198,211
3714,Shannon,Home & Garden,Gardening Tools,68.01,67,1,66
3715,Pamela,Electronics,Headphones,InvalidPrice,378,139,239
3716,Amy,Home & Garden,Decor,364.01,117,41,76
3717,Pamela,Electronics,Headphones,651.11,500,311,189
3718,Elizabeth,Clothing,Shirt,840.19,314,52,262
3719,Shawn,Electronics,Headphones,461.09,315,44,271
3720,Shannon,Home & Garden,Gardening Tools,68.01,118,55,63
3721,Cynthia,Electronics,Headphones,872.85,476,328,148
3722,Marvin,Clothing,Shirt,995.13,155,116,39
3723,Tammy,Home & Garden,Furniture,431.82,259,45,214
3724,NonExistentProduct,Books,Academic,951.53,236,196,40
3725,Katie,Books,Non-fiction,642.11,209,89,120
3726,Cynthia,Electronics,Headphones,872.85,336,280,56
3727,NonExistentProduct,InvalidCategory,Headphones,461.09,180,109,71
3728,Fred,Books,Academic,0.01,403,104,299
3729,NonExistentProduct,Electronics,Headphones,InvalidPrice,205,80,125
3730,Pamela,Electronics,Headphones,651.11,94,42,52
3731,NonExistentProduct,Clothing,Shirt,99999.99,231,27,204
3732,NonExistentProduct,Toys,Educational,26861.0,76,72,4
3733,Nathaniel,Electronics,Camera,652.35,253,91,162
3734,Kristine,Electronics,Headphones,228.82,406,24,382
3735,Angela,Toys,Action Figures,386.57,414,105,309
3736,Anthony,Books,Academic,693.39,198,60,138
3737,Shawn,Electronics,Headphones,461.09,346,238,108
3738,Katie,Books,Non-fiction,0.01,223,52,171
3739,NonExistentProduct,Clothing,Shirt,99513.0,190,145,45
3740,Nathaniel,Electronics,Camera,InvalidPrice,287,128,159
3741,Fred,Books,Academic,InvalidPrice,184,160,24
3742,Katie,Books,Non-fiction,642.11,466,126,340
3743,Michael,Toys,Dolls,46.23,295,141,154
3744,Amy,Home & Garden,Decor,364.01,221,190,31
3745,Elizabeth,Clothing,Shirt,InvalidPrice,124,53,71
3746,Fred,Books,Academic,99999.99,404,236,168
3747,Martha,Books,Fiction,433.1,165,85,80
3748,Katie,Books,Non-fiction,642.11,147,93,54
3749,Wanda,Toys,Educational,268.61,385,60,325
3750,Martha,Books,Fiction,433.1,428,285,143
3751,Wanda,Toys,Educational,268.61,444,421,23
3752,Marvin,Clothing,Shirt,995.13,239,101,138
3753,Elizabeth,Clothing,Shirt,99999.99,75,69,6
3754,Cynthia,Electronics,Headphones,87285.0,170,40,130
3755,Pamela,Electronics,Headphones,651.11,317,282,35
3756,Kristine,Electronics,Headphones,InvalidPrice,386,44,342
3757,Robert,InvalidCategory,Mobile,847.43,330,214,116
3758,Fred,Books,Academic,0.01,66,59,7
3759,Shannon,Home & Garden,Gardening Tools,68.01,176,49,127
3760,Martha,Books,Fiction,InvalidPrice,394,294,100
3761,Fred,Books,Academic,951.53,260,93,167
3762,Justin,Electronics,Headphones,InvalidPrice,100,61,39
3763,Amy,Home & Garden,Decor,0.01,352,70,282
3764,Elizabeth,Clothing,Shirt,840.19,169,26,143
3765,Shawn,Electronics,Headphones,461.09,222,214,8
3766,NonExistentProduct,Electronics,Headphones,0.01,347,174,173
3767,Fred,Books,Academic,95153.0,229,193,36
3768,NonExistentProduct,Books,Academic,951.53,69,19,50
3769,Fred,Books,Academic,InvalidPrice,412,75,337
3770,Shannon,Home & Garden,Gardening Tools,68.01,306,242,64
3771,Cynthia,Electronics,Headphones,InvalidPrice,239,107,132
3772,Tammy,Home & Garden,Furniture,43182.0,449,407,42
3773,NonExistentProduct,Electronics,Headphones,228.82,427,18,409
3774,Michael,Toys,Dolls,4623.0,341,15,326
3775,Fred,Books,Academic,0.01,456,94,362
3776,Fred,Books,Academic,95153.0,436,398,38
3777,Kristine,Electronics,Headphones,228.82,166,22,144
3778,Fred,Books,Academic,InvalidPrice,159,26,133
3779,Wanda,Toys,Educational,InvalidPrice,69,4,65
3780,Shawn,Electronics,Headphones,461.09,433,431,2
3781,Anthony,Books,Academic,693.39,53,19,34
3782,Martha,InvalidCategory,Fiction,433.1,458,140,318
3783,Shawn,InvalidCategory,Headphones,461.09,488,6,482
3784,Katie,Books,Non-fiction,64211.0,379,329,50
3785,Cynthia,Electronics,Headphones,872.85,63,37,26
3786,Shawn,Electronics,Headphones,461.09,212,110,102
3787,Martha,Books,Fiction,433.1,101,32,69
3788,Wanda,Toys,Educational,InvalidPrice,292,59,233
3789,Tammy,Home & Garden,Furniture,431.82,224,191,33
3790,Martha,Books,Fiction,433.1,306,131,175
3791,Kristine,InvalidCategory,Headphones,228.82,121,47,74
3792,Cynthia,Electronics,Headphones,872.85,265,201,64
3793,Martha,Books,Fiction,433.1,283,48,235
3794,NonExistentProduct,Clothing,Shirt,995.13,456,448,8
3795,NonExistentProduct,Home & Garden,Gardening Tools,68.01,432,409,23
3796,NonExistentProduct,Home & Garden,Decor,36401.0,464,2,462
3797,Justin,Electronics,Headphones,660.05,187,29,158
3798,Anthony,Books,Academic,693.39,429,27,402
3799,Amy,Home & Garden,Decor,364.01,405,285,120
3800,Angela,InvalidCategory,Action Figures,386.57,357,335,22
3801,Tammy,Home & Garden,Furniture,431.82,283,5,278
3802,Kristine,Electronics,Headphones,228.82,309,8,301
3803,Kristine,Electronics,Headphones,228.82,294,99,195
3804,Marvin,Clothing,Shirt,InvalidPrice,500,106,394
3805,Fred,Books,Academic,951.53,102,22,80
3806,Fred,Books,Academic,0.01,468,287,181
3807,Pamela,Electronics,Headphones,65111.0,188,176,12
3808,Anthony,Books,Academic,69339.0,184,16,168
3809,Marvin,Clothing,Shirt,995.13,283,24,259
3810,Jamie,Books,Fiction,930.3,217,170,47
3811,Kristine,Electronics,Headphones,228.82,189,5,184
3812,Tammy,Home & Garden,Furniture,431.82,426,322,104
3813,Amy,Home & Garden,Decor,364.01,256,22,234
3814,Kristine,Electronics,Headphones,228.82,282,236,46
3815,Anthony,Books,Academic,693.39,328,279,49
3816,Shannon,Home & Garden,Gardening Tools,68.01,152,143,9
3817,NonExistentProduct,InvalidCategory,Shirt,840.19,111,73,38
3818,Elizabeth,Clothing,Shirt,840.19,307,303,4
3819,Martha,Books,Fiction,433.1,499,246,253
3820,Elizabeth,Clothing,Shirt,840.19,90,1,89
3821,Marvin,Clothing,Shirt,995.13,172,82,90
3822,NonExistentProduct,Electronics,Headphones,651.11,95,60,35
3823,Kristine,Electronics,Headphones,99999.99,209,165,44
3824,Marvin,Clothing,Shirt,InvalidPrice,356,146,210
3825,Tammy,Home & Garden,Furniture,431.82,281,44,237
3826,Robert,Electronics,Mobile,847.43,358,251,107
3827,NonExistentProduct,Toys,Dolls,46.23,113,13,100
3828,Shannon,Home & Garden,Gardening Tools,InvalidPrice,406,21,385
3829,Fred,Books,Academic,951.53,479,271,208
3830,Shannon,Home & Garden,Gardening Tools,68.01,256,105,151
3831,Michael,Toys,Dolls,46.23,127,11,116
3832,Wanda,Toys,Educational,268.61,306,236,70
3833,Pamela,Electronics,Headphones,65111.0,193,138,55
3834,Robert,Electronics,Mobile,84743.0,379,41,338
3835,Jamie,Books,Fiction,930.3,443,333,110
3836,Kristine,Electronics,Headphones,228.82,261,5,256
3837,Kristine,Electronics,Headphones,228.82,474,230,244
3838,NonExistentProduct,Electronics,Headphones,461.09,278,266,12
3839,Jamie,Books,Fiction,930.3,491,363,128
3840,Nathaniel,Electronics,Camera,652.35,311,22,289
3841,Jamie,Books,Fiction,930.3,316,252,64
3842,Cynthia,Electronics,Headphones,872.85,203,100,103
3843,NonExistentProduct,Electronics,Headphones,872.85,459,105,354
3844,Amy,InvalidCategory,Decor,364.01,146,86,60
3845,Jamie,Books,Fiction,InvalidPrice,346,337,9
3846,Angela,Toys,Action Figures,99999.99,291,41,250
3847,Cynthia,Electronics,Headphones,872.85,413,191,222
3848,Anthony,Books,Academic,0.01,124,119,5
3849,Elizabeth,InvalidCategory,Shirt,84019.0,230,127,103
3850,Anthony,Books,Academic,693.39,287,197,90
3851,Angela,Toys,Action Figures,386.57,276,215,61
3852,Anthony,Books,Academic,99999.99,131,52,79
3853,NonExistentProduct,Electronics,Headphones,660.05,344,86,258
3854,Nathaniel,Electronics,Camera,652.35,317,216,101
3855,Cynthia,InvalidCategory,Headphones,872.85,474,138,336
3856,Jamie,Books,Fiction,930.3,250,41,209
3857,Kristine,Electronics,Headphones,228.82,320,313,7
3858,Kristine,Electronics,Headphones,228.82,146,96,50
3859,Robert,Electronics,Mobile,847.43,291,33,258
3860,Tammy,InvalidCategory,Furniture,431.82,368,75,293
3861,Shannon,Home & Garden,Gardening Tools,68.01,51,40,11
3862,Angela,Toys,Action Figures,0.01,403,266,137
3863,Robert,Electronics,Mobile,847.43,294,207,87
3864,NonExistentProduct,Books,Academic,69339.0,441,282,159
3865,Anthony,Books,Academic,99999.99,164,148,16
3866,Kristine,Electronics,Headphones,0.01,236,236,0
3867,Katie,Books,Non-fiction,642.11,471,359,112
3868,Cynthia,Electronics,Headphones,InvalidPrice,226,101,125
3869,Anthony,Books,Academic,693.39,188,86,102
3870,Shawn,Electronics,Headphones,461.09,162,72,90
3871,Angela,Toys,Action Figures,386.57,363,344,19
3872,NonExistentProduct,Electronics,Headphones,99999.99,444,13,431
3873,Wanda,Toys,Educational,268.61,402,3,399
3874,Amy,Home & Garden,Decor,0.01,74,12,62
3875,Shawn,Electronics,Headphones,461.09,347,320,27
3876,Fred,Books,Academic,951.53,389,134,255
3877,Shawn,Electronics,Headphones,46109.0,490,202,288
3878,Angela,Toys,Action Figures,InvalidPrice,216,36,180
3879,NonExistentProduct,Electronics,Camera,652.35,167,11,156
3880,Angela,Toys,Action Figures,386.57,179,169,10
3881,Shawn,Electronics,Headphones,461.09,410,379,31
3882,Robert,Electronics,Mobile,847.43,111,8,103
3883,Amy,Home & Garden,Decor,36401.0,55,13,42
3884,Angela,InvalidCategory,Action Figures,386.57,285,86,199
3885,Amy,Home & Garden,Decor,364.01,376,102,274
3886,Martha,Books,Fiction,InvalidPrice,464,411,53
3887,Cynthia,Electronics,Headphones,872.85,257,119,138
3888,Shawn,Electronics,Headphones,461.09,157,50,107
3889,Amy,Home & Garden,Decor,364.01,436,128,308
3890,Kristine,Electronics,Headphones,99999.99,468,75,393
3891,Justin,Electronics,Headphones,660.05,336,301,35
3892,Nathaniel,Electronics,Camera,652.35,86,50,36
3893,Justin,Electronics,Headphones,660.05,251,125,126
3894,Martha,Books,Fiction,433.1,485,153,332
3895,Shawn,InvalidCategory,Headphones,461.09,217,162,55
3896,Marvin,Clothing,Shirt,995.13,76,70,6
3897,Anthony,Books,Academic,693.39,479,211,268
3898,Amy,Home & Garden,Decor,36401.0,96,11,85
3899,Amy,Home & Garden,Decor,364.01,232,159,73
3900,Amy,Home & Garden,Decor,364.01,334,306,28
3901,Elizabeth,Clothing,Shirt,840.19,137,137,0
3902,Justin,InvalidCategory,Headphones,660.05,409,56,353
3903,Marvin,Clothing,Shirt,995.13,400,357,43
3904,Wanda,Toys,Educational,99999.99,229,84,145
3905,Martha,Books,Fiction,433.1,332,238,94
3906,Elizabeth,Clothing,Shirt,840.19,222,161,61
3907,Fred,Books,Academic,95153.0,339,256,83
3908,Jamie,Books,Fiction,930.3,142,51,91
3909,Shawn,Electronics,Headphones,461.09,180,175,5
3910,Angela,Toys,Action Figures,386.57,426,199,227
3911,Anthony,Books,Academic,InvalidPrice,431,208,223
3912,Pamela,Electronics,Headphones,651.11,89,56,33
3913,Shawn,Electronics,Headphones,461.09,466,229,237
3914,Anthony,Books,Academic,693.39,207,193,14
3915,Shawn,Electronics,Headphones,99999.99,243,96,147
3916,Robert,InvalidCategory,Mobile,84743.0,340,110,230
3917,Fred,Books,Academic,951.53,86,63,23
3918,Robert,Electronics,Mobile,847.43,252,195,57
3919,Shannon,Home & Garden,Gardening Tools,68.01,374,91,283
3920,Michael,Toys,Dolls,4623.0,127,72,55
3921,Robert,InvalidCategory,Mobile,847.43,300,107,193
3922,Wanda,Toys,Educational,268.61,187,164,23
3923,Justin,Electronics,Headphones,66005.0,91,68,23
3924,Kristine,Electronics,Headphones,228.82,374,374,0
3925,NonExistentProduct,Electronics,Headphones,651.11,394,392,2
3926,Justin,Electronics,Headphones,660.05,408,403,5
3927,Elizabeth,Clothing,Shirt,840.19,351,52,299
3928,Tammy,Home & Garden,Furniture,431.82,147,64,83
3929,Pamela,Electronics,Headphones,651.11,67,58,9
3930,Pamela,Electronics,Headphones,651.11,465,357,108
3931,Jamie,Books,Fiction,99999.99,408,13,395
3932,Cynthia,Electronics,Headphones,872.85,409,145,264
3933,Justin,Electronics,Headphones,660.05,256,15,241
3934,Marvin,Clothing,Shirt,995.13,455,385,70
3935,Anthony,InvalidCategory,Academic,693.39,217,145,72
3936,Wanda,InvalidCategory,Educational,268.61,478,261,217
3937,Pamela,Electronics,Headphones,651.11,150,115,35
3938,Shannon,Home & Garden,Gardening Tools,InvalidPrice,393,153,240
3939,NonExistentProduct,Electronics,Camera,652.35,268,185,83
3940,Katie,Books,Non-fiction,InvalidPrice,362,15,347
3941,Jamie,Books,Fiction,930.3,368,311,57
3942,Shannon,InvalidCategory,Gardening Tools,68.01,481,440,41
3943,Kristine,Electronics,Headphones,228.82,92,38,54
3944,Michael,Toys,Dolls,46.23,491,289,202
3945,Justin,Electronics,Headphones,660.05,432,365,67
3946,Amy,Home & Garden,Decor,99999.99,290,18,272
3947,Tammy,Home & Garden,Furniture,0.01,73,11,62
3948,Pamela,Electronics,Headphones,651.11,498,498,0
3949,Amy,Home & Garden,Decor,364.01,237,123,114
3950,Anthony,InvalidCategory,Academic,693.39,360,276,84
3951,Michael,Toys,Dolls,99999.99,177,48,129
3952,Shawn,Electronics,Headphones,461.09,180,8,172
3953,Tammy,Home & Garden,Furniture,43182.0,99,11,88
3954,Tammy,Home & Garden,Furniture,431.82,193,53,140
3955,Anthony,Books,Academic,69339.0,156,32,124
3956,Elizabeth,InvalidCategory,Shirt,840.19,395,179,216
3957,Shawn,Electronics,Headphones,461.09,91,38,53
3958,NonExistentProduct,Toys,Dolls,InvalidPrice,484,3,481
3959,Marvin,Clothing,Shirt,995.13,57,34,23
3960,Angela,InvalidCategory,Action Figures,0.01,456,56,400
3961,Amy,Home & Garden,Decor,364.01,420,24,396
3962,Kristine,Electronics,Headphones,99999.99,129,4,125
3963,NonExistentProduct,Books,Academic,InvalidPrice,151,131,20
3964,Pamela,Electronics,Headphones,InvalidPrice,437,126,311
3965,Pamela,Electronics,Headphones,651.11,235,164,71
3966,NonExistentProduct,Books,Academic,95153.0,186,61,125
3967,Tammy,InvalidCategory,Furniture,431.82,325,41,284
3968,Amy,Home & Garden,Decor,364.01,498,494,4
3969,Katie,Books,Non-fiction,642.11,269,80,189
3970,Kristine,Electronics,Headphones,228.82,430,169,261
3971,Elizabeth,Clothing,Shirt,0.01,302,261,41
3972,Fred,Books,Academic,951.53,111,4,107
3973,Elizabeth,Clothing,Shirt,84019.0,420,229,191
3974,Marvin,Clothing,Shirt,0.01,425,149,276
3975,Shannon,Home & Garden,Gardening Tools,68.01,423,345,78
3976,Jamie,Books,Fiction,930.3,336,14,322
3977,Tammy,Home & Garden,Furniture,InvalidPrice,457,411,46
3978,Fred,Books,Academic,951.53,188,142,46
3979,Michael,Toys,Dolls,46.23,145,116,29
3980,Nathaniel,Electronics,Camera,65235.0,354,72,282
3981,Amy,Home & Garden,Decor,InvalidPrice,164,75,89
3982,Kristine,Electronics,Headphones,22882.0,318,288,30
3983,Jamie,Books,Fiction,930.3,283,243,40
3984,Michael,Toys,Dolls,46.23,87,68,19
3985,Shawn,Electronics,Headphones,461.09,211,194,17
3986,Angela,InvalidCategory,Action Figures,386.57,417,219,198
3987,Justin,Electronics,Headphones,99999.99,416,256,160
3988,Tammy,Home & Garden,Furniture,431.82,445,350,95
3989,Fred,Books,Academic,951.53,130,92,38
3990,Robert,Electronics,Mobile,847.43,59,11,48
3991,Michael,Toys,Dolls,46.23,446,110,336
3992,Robert,Electronics,Mobile,84743.0,281,253,28
3993,Fred,Books,Academic,99999.99,143,33,110
3994,Fred,Books,Academic,951.53,270,61,209
3995,Nathaniel,Electronics,Camera,652.35,99,6,93
3996,Justin,Electronics,Headphones,660.05,408,224,184
3997,Shannon,Home & Garden,Gardening Tools,68.01,378,215,163
3998,Katie,Books,Non-fiction,642.11,146,5,141
3999,Wanda,Toys,Educational,268.61,226,143,83
4000,Robert,Electronics,Mobile,847.43,405,318,87
4001,Marvin,Clothing,Shirt,995.13,117,82,35
4002,Shawn,InvalidCategory,Headphones,461.09,334,86,248
4003,Marvin,Clothing,Shirt,995.13,415,206,209
4004,Shannon,Home & Garden,Gardening Tools,68.01,405,396,9
4005,Angela,Toys,Action Figures,386.57,488,72,416
4006,Marvin,Clothing,Shirt,995.13,291,254,37
4007,Marvin,Clothing,Shirt,995.13,488,249,239
4008,Kristine,Electronics,Headphones,228.82,121,79,42
4009,Pamela,InvalidCategory,Headphones,651.11,470,457,13
4010,Amy,Home & Garden,Decor,99999.99,87,40,47
4011,Jamie,Books,Fiction,0.01,301,156,145
4012,Angela,InvalidCategory,Action Figures,386.57,212,65,147
4013,Katie,Books,Non-fiction,642.11,174,76,98
4014,Shannon,InvalidCategory,Gardening Tools,68.01,496,6,490
4015,Kristine,Electronics,Headphones,InvalidPrice,457,90,367
4016,Wanda,Toys,Educational,268.61,328,25,303
4017,NonExistentProduct,Clothing,Shirt,0.01,262,224,38
4018,Shannon,Home & Garden,Gardening Tools,InvalidPrice,223,64,159
4019,Fred,Books,Academic,951.53,89,26,63
4020,Pamela,Electronics,Headphones,651.11,131,71,60
4021,Kristine,Electronics,Headphones,228.82,447,429,18
4022,Kristine,Electronics,Headphones,228.82,215,13,202
4023,Anthony,Books,Academic,693.39,127,73,54
4024,Fred,Books,Academic,951.53,461,430,31
4025,Michael,Toys,Dolls,46.23,365,245,120
4026,Angela,Toys,Action Figures,38657.0,129,96,33
4027,Amy,Home & Garden,Decor,364.01,349,114,235
4028,Katie,Books,Non-fiction,642.11,254,19,235
4029,Shannon,Home & Garden,Gardening Tools,68.01,110,56,54
4030,Wanda,Toys,Educational,268.61,393,60,333
4031,Anthony,Books,Academic,693.39,395,279,116
4032,NonExistentProduct,Home & Garden,Furniture,99999.99,295,80,215
4033,Cynthia,Electronics,Headphones,872.85,262,191,71
4034,NonExistentProduct,Toys,Dolls,4623.0,65,4,61
4035,Wanda,InvalidCategory,Educational,268.61,226,25,201
4036,Kristine,Electronics,Headphones,228.82,406,389,17
4037,Michael,Toys,Dolls,46.23,396,60,336
4038,Fred,InvalidCategory,Academic,951.53,465,363,102
4039,Anthony,Books,Academic,693.39,173,94,79
4040,Anthony,Books,Academic,InvalidPrice,337,93,244
4041,Fred,InvalidCategory,Academic,InvalidPrice,350,66,284
4042,NonExistentProduct,Toys,Educational,268.61,431,124,307
4043,Anthony,Books,Academic,693.39,75,29,46
4044,Marvin,Clothing,Shirt,995.13,322,261,61
4045,Cynthia,Electronics,Headphones,0.01,378,42,336
4046,Pamela,Electronics,Headphones,65111.0,376,363,13
4047,Amy,Home & Garden,Decor,364.01,76,48,28
4048,Martha,InvalidCategory,Fiction,433.1,272,103,169
4049,Anthony,Books,Academic,693.39,246,52,194
4050,Martha,Books,Fiction,433.1,123,11,112
4051,Martha,Books,Fiction,43310.0,350,147,203
4052,Anthony,Books,Academic,693.39,217,102,115
4053,NonExistentProduct,Clothing,Shirt,995.13,444,394,50
4054,Pamela,Electronics,Headphones,99999.99,336,26,310
4055,Pamela,Electronics,Headphones,651.11,423,318,105
4056,Nathaniel,Electronics,Camera,652.35,152,114,38
4057,Pamela,Electronics,Headphones,651.11,100,32,68
4058,Martha,Books,Fiction,433.1,360,337,23
4059,Anthony,Books,Academic,693.39,275,160,115
4060,NonExistentProduct,Toys,Educational,99999.99,314,301,13
4061,Kristine,Electronics,Headphones,228.82,418,269,149
4062,Fred,Books,Academic,951.53,310,128,182
4063,Shannon,Home & Garden,Gardening Tools,68.01,61,25,36
4064,Angela,Toys,Action Figures,386.57,374,28,346
4065,Tammy,Home & Garden,Furniture,431.82,115,30,85
4066,NonExistentProduct,Electronics,Headphones,651.11,279,46,233
4067,Wanda,Toys,Educational,268.61,294,269,25
4068,Justin,InvalidCategory,Headphones,InvalidPrice,149,109,40
4069,Justin,Electronics,Headphones,660.05,374,50,324
4070,NonExistentProduct,InvalidCategory,Headphones,660.05,364,338,26
4071,Marvin,Clothing,Shirt,InvalidPrice,159,31,128
4072,Marvin,Clothing,Shirt,995.13,461,358,103
4073,Marvin,Clothing,Shirt,99999.99,270,139,131
4074,Nathaniel,Electronics,Camera,InvalidPrice,414,279,135
4075,Amy,Home & Garden,Decor,364.01,224,83,141
4076,NonExistentProduct,Toys,Dolls,InvalidPrice,439,179,260
4077,Jamie,Books,Fiction,930.3,199,66,133
4078,Shawn,InvalidCategory,Headphones,461.09,100,45,55
4079,Anthony,Books,Academic,693.39,135,30,105
4080,Martha,Books,Fiction,433.1,241,7,234
4081,Tammy,Home & Garden,Furniture,431.82,98,49,49
4082,Cynthia,InvalidCategory,Headphones,872.85,194,77,117
4083,Jamie,Books,Fiction,93030.0,270,161,109
4084,NonExistentProduct,Electronics,Camera,652.35,282,175,107
4085,Robert,Electronics,Mobile,847.43,311,258,53
4086,Amy,Home & Garden,Decor,364.01,136,73,63
4087,Kristine,Electronics,Headphones,0.01,391,168,223
4088,Anthony,Books,Academic,693.39,480,7,473
4089,Marvin,Clothing,Shirt,995.13,420,246,174
4090,Angela,InvalidCategory,Action Figures,386.57,458,284,174
4091,Katie,Books,Non-fiction,642.11,183,144,39
4092,Tammy,Home & Garden,Furniture,431.82,425,51,374
4093,Nathaniel,Electronics,Camera,652.35,372,95,277
4094,Nathaniel,Electronics,Camera,652.35,423,49,374
4095,Shawn,Electronics,Headphones,0.01,454,284,170
4096,Katie,Books,Non-fiction,InvalidPrice,410,217,193
4097,NonExistentProduct,Toys,Dolls,46.23,351,48,303
4098,Nathaniel,Electronics,Camera,652.35,390,229,161
4099,Shawn,Electronics,Headphones,461.09,77,75,2
4100,Nathaniel,Electronics,Camera,99999.99,62,3,59
4101,Amy,Home & Garden,Decor,364.01,118,1,117
4102,Justin,Electronics,Headphones,InvalidPrice,125,7,118
4103,Tammy,Home & Garden,Furniture,431.82,405,247,158
4104,Justin,Electronics,Headphones,660.05,151,36,115
4105,Shawn,Electronics,Headphones,461.09,269,121,148
4106,Michael,Toys,Dolls,46.23,376,234,142
4107,Katie,Books,Non-fiction,642.11,427,231,196
4108,Fred,Books,Academic,951.53,245,26,219
4109,Kristine,Electronics,Headphones,228.82,80,5,75
4110,Robert,Electronics,Mobile,847.43,143,79,64
4111,Justin,Electronics,Headphones,660.05,309,227,82
4112,Nathaniel,InvalidCategory,Camera,65235.0,102,60,42
4113,Marvin,Clothing,Shirt,995.13,224,150,74
4114,Amy,Home & Garden,Decor,36401.0,290,208,82
4115,Wanda,Toys,Educational,99999.99,348,101,247
4116,Nathaniel,Electronics,Camera,652.35,264,76,188
4117,Nathaniel,Electronics,Camera,652.35,340,5,335
4118,Fred,Books,Academic,951.53,352,162,190
4119,Amy,Home & Garden,Decor,36401.0,421,202,219
4120,Anthony,InvalidCategory,Academic,693.39,64,57,7
4121,Katie,Books,Non-fiction,642.11,201,116,85
4122,Justin,Electronics,Headphones,660.05,473,72,401
4123,Shawn,Electronics,Headphones,461.09,134,10,124
4124,Cynthia,Electronics,Headphones,872.85,341,257,84
4125,Wanda,InvalidCategory,Educational,26861.0,326,278,48
4126,Anthony,Books,Academic,99999.99,250,217,33
4127,Angela,Toys,Action Figures,386.57,159,18,141
4128,Anthony,Books,Academic,693.39,299,109,190
4129,Elizabeth,Clothing,Shirt,99999.99,414,20,394
4130,Michael,Toys,Dolls,46.23,211,15,196
4131,Justin,Electronics,Headphones,660.05,385,33,352
4132,Elizabeth,Clothing,Shirt,840.19,218,182,36
4133,Shannon,Home & Garden,Gardening Tools,InvalidPrice,113,95,18
4134,Cynthia,Electronics,Headphones,872.85,93,47,46
4135,NonExistentProduct,Books,Fiction,930.3,103,16,87
4136,Kristine,Electronics,Headphones,228.82,53,17,36
4137,Nathaniel,Electronics,Camera,652.35,337,128,209
4138,Pamela,Electronics,Headphones,InvalidPrice,444,363,81
4139,Fred,Books,Academic,951.53,143,133,10
4140,Wanda,Toys,Educational,99999.99,286,73,213
4141,Kristine,Electronics,Headphones,22882.0,458,400,58
4142,Angela,Toys,Action Figures,386.57,282,99,183
4143,Anthony,Books,Academic,693.39,444,13,431
4144,Shawn,Electronics,Headphones,461.09,70,52,18
4145,Katie,Books,Non-fiction,642.11,309,3,306
4146,Michael,Toys,Dolls,46.23,102,53,49
4147,Nathaniel,Electronics,Camera,0.01,346,57,289
4148,Marvin,Clothing,Shirt,InvalidPrice,471,259,212
4149,Michael,Toys,Dolls,46.23,457,165,292
4150,Wanda,Toys,Educational,268.61,177,32,145
4151,Michael,Toys,Dolls,46.23,434,417,17
4152,Michael,Toys,Dolls,0.01,140,118,22
4153,Wanda,Toys,Educational,26861.0,444,257,187
4154,Fred,Books,Academic,951.53,132,39,93
4155,Wanda,Toys,Educational,268.61,88,77,11
4156,Kristine,Electronics,Headphones,228.82,303,204,99
4157,Anthony,Books,Academic,693.39,476,319,157
4158,Marvin,Clothing,Shirt,995.13,115,46,69
4159,Justin,Electronics,Headphones,660.05,145,95,50
4160,NonExistentProduct,Clothing,Shirt,840.19,148,63,85
4161,Kristine,Electronics,Headphones,228.82,207,126,81
4162,Shannon,Home & Garden,Gardening Tools,68.01,352,81,271
4163,Amy,Home & Garden,Decor,36401.0,203,127,76
4164,Marvin,InvalidCategory,Shirt,995.13,228,67,161
4165,Angela,Toys,Action Figures,0.01,181,24,157
4166,Martha,Books,Fiction,43310.0,194,42,152
4167,Fred,InvalidCategory,Academic,951.53,408,401,7
4168,Katie,Books,Non-fiction,64211.0,242,238,4
4169,NonExistentProduct,Electronics,Headphones,InvalidPrice,422,286,136
4170,Robert,Electronics,Mobile,847.43,208,173,35
4171,Pamela,Electronics,Headphones,651.11,417,382,35
4172,Michael,Toys,Dolls,46.23,368,318,50
4173,NonExistentProduct,Home & Garden,Furniture,0.01,130,64,66
4174,Robert,InvalidCategory,Mobile,InvalidPrice,479,38,441
4175,Shannon,Home & Garden,Gardening Tools,68.01,457,147,310
4176,Pamela,Electronics,Headphones,99999.99,135,79,56
4177,Pamela,InvalidCategory,Headphones,651.11,61,7,54
4178,Cynthia,Electronics,Headphones,872.85,226,163,63
4179,Jamie,InvalidCategory,Fiction,930.3,338,233,105
4180,Nathaniel,Electronics,Camera,652.35,142,68,74
4181,Nathaniel,Electronics,Camera,652.35,149,9,140
4182,Elizabeth,Clothing,Shirt,84019.0,451,187,264
4183,Martha,Books,Fiction,99999.99,233,189,44
4184,Angela,InvalidCategory,Action Figures,386.57,179,9,170
4185,Cynthia,Electronics,Headphones,99999.99,181,175,6
4186,Michael,InvalidCategory,Dolls,46.23,168,127,41
4187,Pamela,Electronics,Headphones,651.11,330,49,281
4188,Fred,Books,Academic,InvalidPrice,463,30,433
4189,Elizabeth,Clothing,Shirt,840.19,305,258,47
4190,NonExistentProduct,Home & Garden,Decor,364.01,187,101,86
4191,Shawn,Electronics,Headphones,46109.0,224,21,203
4192,Pamela,InvalidCategory,Headphones,651.11,488,34,454
4193,Justin,Electronics,Headphones,66005.0,386,117,269
4194,Katie,Books,Non-fiction,642.11,68,57,11
4195,Jamie,Books,Fiction,930.3,230,117,113
4196,NonExistentProduct,InvalidCategory,Headphones,651.11,276,105,171
4197,Michael,Toys,Dolls,46.23,61,12,49
4198,Anthony,Books,Academic,693.39,260,8,252
4199,Shannon,Home & Garden,Gardening Tools,68.01,446,64,382
4200,NonExistentProduct,Electronics,Headphones,651.11,393,275,118
4201,Robert,Electronics,Mobile,84743.0,185,106,79
4202,Katie,Books,Non-fiction,642.11,479,199,280
4203,Tammy,Home & Garden,Furniture,43182.0,228,155,73
4204,Jamie,Books,Fiction,930.3,211,56,155
4205,NonExistentProduct,Books,Fiction,433.1,95,59,36
4206,Elizabeth,Clothing,Shirt,840.19,499,410,89
4207,Shannon,Home & Garden,Gardening Tools,0.01,490,381,109
4208,Pamela,Electronics,Headphones,651.11,244,57,187
4209,Jamie,Books,Fiction,930.3,376,209,167
4210,Tammy,Home & Garden,Furniture,431.82,352,132,220
4211,Michael,Toys,Dolls,46.23,132,86,46
4212,Angela,Toys,Action Figures,386.57,62,27,35
4213,Jamie,InvalidCategory,Fiction,930.3,104,57,47
4214,Amy,Home & Garden,Decor,364.01,489,444,45
4215,Shawn,Electronics,Headphones,461.09,376,90,286
4216,Shawn,Electronics,Headphones,0.01,432,218,214
4217,Jamie,Books,Fiction,930.3,463,246,217
4218,Tammy,Home & Garden,Furniture,431.82,344,175,169
4219,Cynthia,Electronics,Headphones,87285.0,156,154,2
4220,Angela,Toys,Action Figures,386.57,287,75,212
4221,Anthony,Books,Academic,693.39,290,51,239
4222,Wanda,Toys,Educational,InvalidPrice,323,127,196
4223,Angela,Toys,Action Figures,0.01,318,47,271
4224,NonExistentProduct,Toys,Action Figures,386.57,394,206,188
4225,Tammy,Home & Garden,Furniture,431.82,422,395,27
4226,Shannon,InvalidCategory,Gardening Tools,68.01,417,84,333
4227,Wanda,Toys,Educational,268.61,363,27,336
4228,Jamie,Books,Fiction,93030.0,130,26,104
4229,Michael,InvalidCategory,Dolls,46.23,443,62,381
4230,Shawn,Electronics,Headphones,461.09,325,307,18
4231,Robert,Electronics,Mobile,847.43,233,178,55
4232,Wanda,Toys,Educational,0.01,335,192,143
4233,Jamie,Books,Fiction,930.3,476,59,417
4234,Tammy,Home & Garden,Furniture,431.82,110,32,78
4235,Elizabeth,Clothing,Shirt,84019.0,343,279,64
4236,Martha,Books,Fiction,433.1,299,242,57
4237,Angela,Toys,Action Figures,InvalidPrice,50,6,44
4238,Martha,Books,Fiction,43310.0,166,99,67
4239,Anthony,Books,Academic,69339.0,216,132,84
4240,Michael,Toys,Dolls,4623.0,481,152,329
4241,Robert,Electronics,Mobile,847.43,432,412,20
4242,NonExistentProduct,Toys,Action Figures,386.57,312,128,184
4243,Robert,Electronics,Mobile,84743.0,316,197,119
4244,Amy,Home & Garden,Decor,364.01,57,17,40
4245,Fred,Books,Academic,951.53,313,117,196
4246,Michael,Toys,Dolls,46.23,69,28,41
4247,Martha,Books,Fiction,433.1,117,97,20
4248,Angela,Toys,Action Figures,386.57,261,105,156
4249,Anthony,Books,Academic,99999.99,472,28,444
4250,Shawn,InvalidCategory,Headphones,461.09,107,82,25
4251,Michael,Toys,Dolls,46.23,167,134,33
4252,Pamela,Electronics,Headphones,651.11,353,137,216
4253,Elizabeth,Clothing,Shirt,840.19,123,56,67
4254,NonExistentProduct,Clothing,Shirt,InvalidPrice,354,235,119
4255,Pamela,Electronics,Headphones,InvalidPrice,172,133,39
4256,Katie,Books,Non-fiction,InvalidPrice,403,319,84
4257,Shawn,Electronics,Headphones,461.09,280,249,31
4258,Nathaniel,Electronics,Camera,652.35,448,373,75
4259,Marvin,Clothing,Shirt,995.13,302,9,293
4260,NonExistentProduct,Electronics,Camera,652.35,496,401,95
4261,Katie,Books,Non-fiction,642.11,330,250,80
4262,Martha,Books,Fiction,433.1,236,134,102
4263,Amy,Home & Garden,Decor,99999.99,145,142,3
4264,Michael,Toys,Dolls,46.23,258,49,209
4265,Martha,Books,Fiction,433.1,175,81,94
4266,Martha,Books,Fiction,99999.99,398,388,10
4267,Justin,Electronics,Headphones,660.05,61,52,9
4268,Fred,Books,Academic,951.53,268,140,128
4269,Shannon,Home & Garden,Gardening Tools,68.01,144,133,11
4270,Marvin,Clothing,Shirt,995.13,107,104,3
4271,Wanda,Toys,Educational,268.61,442,36,406
4272,Nathaniel,Electronics,Camera,652.35,319,6,313
4273,Shawn,Electronics,Headphones,461.09,500,143,357
4274,Fred,Books,Academic,951.53,222,219,3
4275,Anthony,Books,Academic,693.39,185,39,146
4276,NonExistentProduct,Electronics,Mobile,847.43,421,47,374
4277,Shannon,Home & Garden,Gardening Tools,68.01,120,17,103
4278,NonExistentProduct,Electronics,Headphones,660.05,222,125,97
4279,Wanda,Toys,Educational,268.61,271,215,56
4280,Shannon,Home & Garden,Gardening Tools,68.01,460,330,130
4281,NonExistentProduct,Home & Garden,Gardening Tools,68.01,485,3,482
4282,Justin,Electronics,Headphones,InvalidPrice,495,208,287
4283,Fred,InvalidCategory,Academic,951.53,242,233,9
4284,Nathaniel,Electronics,Camera,652.35,367,278,89
4285,NonExistentProduct,Books,Academic,951.53,227,164,63
4286,Michael,Toys,Dolls,46.23,228,210,18
4287,Robert,Electronics,Mobile,847.43,126,71,55
4288,Shannon,Home & Garden,Gardening Tools,6801.000000000001,63,25,38
4289,Katie,Books,Non-fiction,642.11,334,4,330
4290,Cynthia,Electronics,Headphones,InvalidPrice,131,108,23
4291,Shawn,Electronics,Headphones,0.01,373,303,70
4292,Robert,Electronics,Mobile,847.43,257,114,143
4293,Pamela,Electronics,Headphones,651.11,269,33,236
4294,Kristine,Electronics,Headphones,228.82,109,93,16
4295,Wanda,Toys,Educational,268.61,269,33,236
4296,Marvin,Clothing,Shirt,InvalidPrice,251,161,90
4297,Robert,InvalidCategory,Mobile,847.43,261,139,122
4298,Shannon,InvalidCategory,Gardening Tools,68.01,460,393,67
4299,Fred,Books,Academic,951.53,474,293,181
4300,Tammy,Home & Garden,Furniture,431.82,343,68,275
4301,Cynthia,Electronics,Headphones,872.85,218,7,211
4302,Michael,Toys,Dolls,46.23,187,11,176
4303,Justin,Electronics,Headphones,660.05,69,45,24
4304,Nathaniel,Electronics,Camera,0.01,265,244,21
4305,Kristine,Electronics,Headphones,228.82,384,124,260
4306,Amy,Home & Garden,Decor,0.01,343,220,123
4307,Michael,InvalidCategory,Dolls,0.01,85,23,62
4308,Fred,Books,Academic,951.53,210,105,105
4309,Wanda,Toys,Educational,InvalidPrice,346,40,306
4310,Fred,Books,Academic,951.53,164,81,83
4311,Amy,InvalidCategory,Decor,36401.0,104,6,98
4312,Elizabeth,Clothing,Shirt,840.19,342,128,214
4313,Anthony,Books,Academic,693.39,100,12,88
4314,Martha,Books,Fiction,433.1,327,53,274
4315,NonExistentProduct,Books,Fiction,930.3,476,99,377
4316,Amy,Home & Garden,Decor,0.01,454,210,244
4317,Robert,InvalidCategory,Mobile,847.43,281,70,211
4318,Anthony,Books,Academic,InvalidPrice,418,378,40
4319,Tammy,Home & Garden,Furniture,431.82,124,100,24
4320,Amy,Home & Garden,Decor,36401.0,249,12,237
4321,Shawn,Electronics,Headphones,461.09,213,80,133
4322,Katie,Books,Non-fiction,642.11,72,27,45
4323,Anthony,InvalidCategory,Academic,InvalidPrice,351,181,170
4324,Kristine,Electronics,Headphones,228.82,362,108,254
4325,Nathaniel,Electronics,Camera,652.35,283,3,280
4326,Katie,Books,Non-fiction,64211.0,301,256,45
4327,Anthony,Books,Academic,693.39,473,202,271
4328,Jamie,Books,Fiction,930.3,149,113,36
4329,Martha,Books,Fiction,433.1,64,38,26
4330,Nathaniel,InvalidCategory,Camera,652.35,469,43,426
4331,Justin,Electronics,Headphones,660.05,417,305,112
4332,Robert,Electronics,Mobile,847.43,117,32,85
4333,NonExistentProduct,Books,Fiction,99999.99,187,24,163
4334,Michael,Toys,Dolls,46.23,427,395,32
4335,Kristine,Electronics,Headphones,228.82,219,60,159
4336,NonExistentProduct,Electronics,Headphones,651.11,435,173,262
4337,Nathaniel,Electronics,Camera,652.35,432,260,172
4338,Shannon,Home & Garden,Gardening Tools,99999.99,276,218,58
4339,Tammy,InvalidCategory,Furniture,431.82,173,160,13
4340,NonExistentProduct,Books,Academic,951.53,400,288,112
4341,Anthony,Books,Academic,693.39,328,40,288
4342,Robert,Electronics,Mobile,847.43,492,459,33
4343,Shannon,Home & Garden,Gardening Tools,68.01,150,27,123
4344,Martha,Books,Fiction,InvalidPrice,96,54,42
4345,Angela,Toys,Action Figures,386.57,226,168,58
4346,NonExistentProduct,Clothing,Shirt,995.13,325,97,228
4347,Anthony,InvalidCategory,Academic,693.39,346,289,57
4348,Nathaniel,Electronics,Camera,InvalidPrice,388,53,335
4349,Elizabeth,Clothing,Shirt,840.19,384,227,157
4350,Shannon,Home & Garden,Gardening Tools,68.01,224,172,52
4351,NonExistentProduct,InvalidCategory,Furniture,431.82,279,88,191
4352,Wanda,Toys,Educational,268.61,328,204,124
4353,Wanda,Toys,Educational,268.61,178,138,40
4354,Anthony,Books,Academic,693.39,180,117,63
4355,Elizabeth,Clothing,Shirt,840.19,105,61,44
4356,Justin,Electronics,Headphones,66005.0,323,184,139
4357,Shawn,InvalidCategory,Headphones,461.09,51,34,17
4358,Amy,Home & Garden,Decor,364.01,293,142,151
4359,NonExistentProduct,Clothing,Shirt,840.19,493,107,386
4360,NonExistentProduct,Electronics,Headphones,872.85,281,3,278
4361,Nathaniel,Electronics,Camera,0.01,68,32,36
4362,NonExistentProduct,Books,Fiction,930.3,409,335,74
4363,NonExistentProduct,InvalidCategory,Academic,InvalidPrice,297,43,254
4364,Anthony,Books,Academic,693.39,166,97,69
4365,Amy,Home & Garden,Decor,364.01,76,18,58
4366,Michael,Toys,Dolls,46.23,460,302,158
4367,Justin,Electronics,Headphones,660.05,363,108,255
4368,Shannon,Home & Garden,Gardening Tools,99999.99,210,147,63
4369,Cynthia,Electronics,Headphones,872.85,409,121,288
4370,Wanda,Toys,Educational,26861.0,286,118,168
4371,Martha,Books,Fiction,433.1,388,365,23
4372,Pamela,Electronics,Headphones,65111.0,352,178,174
4373,Marvin,Clothing,Shirt,995.13,440,141,299
4374,Amy,Home & Garden,Decor,364.01,271,204,67
4375,NonExistentProduct,InvalidCategory,Shirt,995.13,347,103,244
4376,Justin,Electronics,Headphones,0.01,108,69,39
4377,Wanda,Toys,Educational,0.01,215,120,95
4378,Robert,Electronics,Mobile,847.43,118,22,96
4379,Angela,Toys,Action Figures,386.57,497,68,429
4380,Pamela,Electronics,Headphones,651.11,373,145,228
4381,Michael,Toys,Dolls,InvalidPrice,476,380,96
4382,Jamie,Books,Fiction,930.3,350,48,302
4383,Michael,InvalidCategory,Dolls,46.23,62,11,51
4384,Katie,Books,Non-fiction,0.01,218,80,138
4385,Fred,Books,Academic,95153.0,247,103,144
4386,Tammy,Home & Garden,Furniture,431.82,436,319,117
4387,Robert,Electronics,Mobile,84743.0,181,141,40
4388,Anthony,Books,Academic,693.39,183,117,66
4389,Wanda,Toys,Educational,268.61,366,163,203
4390,Shannon,InvalidCategory,Gardening Tools,68.01,499,127,372
4391,Kristine,InvalidCategory,Headphones,228.82,319,110,209
4392,Katie,Books,Non-fiction,642.11,52,3,49
4393,Jamie,Books,Fiction,0.01,125,119,6
4394,NonExistentProduct,Electronics,Headphones,0.01,200,98,102
4395,Wanda,Toys,Educational,268.61,481,223,258
4396,Justin,Electronics,Headphones,660.05,73,9,64
4397,Katie,Books,Non-fiction,642.11,72,5,67
4398,Elizabeth,InvalidCategory,Shirt,840.19,351,349,2
4399,Angela,InvalidCategory,Action Figures,386.57,115,50,65
4400,Angela,InvalidCategory,Action Figures,386.57,354,137,217
4401,Kristine,Electronics,Headphones,228.82,74,74,0
4402,Amy,InvalidCategory,Decor,364.01,449,35,414
4403,Robert,Electronics,Mobile,0.01,488,274,214
4404,Angela,Toys,Action Figures,386.57,433,362,71
4405,Wanda,Toys,Educational,InvalidPrice,456,241,215
4406,Angela,Toys,Action Figures,99999.99,73,54,19
4407,Wanda,Toys,Educational,26861.0,225,102,123
4408,Fred,Books,Academic,InvalidPrice,158,117,41
4409,Elizabeth,InvalidCategory,Shirt,840.19,347,102,245
4410,Amy,Home & Garden,Decor,36401.0,369,75,294
4411,Angela,Toys,Action Figures,38657.0,458,440,18
4412,Shannon,Home & Garden,Gardening Tools,68.01,430,312,118
4413,Shannon,InvalidCategory,Gardening Tools,68.01,364,353,11
4414,Elizabeth,Clothing,Shirt,840.19,356,46,310
4415,Wanda,Toys,Educational,268.61,100,41,59
4416,Michael,Toys,Dolls,46.23,265,161,104
4417,Katie,Books,Non-fiction,64211.0,445,178,267
4418,Justin,Electronics,Headphones,660.05,350,129,221
4419,Marvin,Clothing,Shirt,995.13,181,20,161
4420,Katie,Books,Non-fiction,642.11,430,352,78
4421,Justin,Electronics,Headphones,660.05,185,151,34
4422,NonExistentProduct,Home & Garden,Decor,364.01,162,123,39
4423,Martha,Books,Fiction,433.1,193,112,81
4424,Amy,Home & Garden,Decor,364.01,55,17,38
4425,Marvin,Clothing,Shirt,995.13,459,353,106
4426,Marvin,Clothing,Shirt,995.13,447,348,99
4427,Elizabeth,Clothing,Shirt,99999.99,69,65,4
4428,Elizabeth,Clothing,Shirt,InvalidPrice,240,54,186
4429,Robert,Electronics,Mobile,847.43,121,110,11
4430,Martha,Books,Fiction,433.1,108,41,67
4431,Michael,Toys,Dolls,46.23,111,14,97
4432,Katie,Books,Non-fiction,0.01,349,246,103
4433,Shannon,Home & Garden,Gardening Tools,68.01,108,65,43
4434,Amy,Home & Garden,Decor,364.01,191,171,20
4435,Fred,Books,Academic,InvalidPrice,136,21,115
4436,Shawn,Electronics,Headphones,InvalidPrice,232,133,99
4437,NonExistentProduct,Electronics,Headphones,InvalidPrice,223,136,87
4438,NonExistentProduct,Electronics,Mobile,847.43,384,339,45
4439,Pamela,Electronics,Headphones,651.11,172,156,16
4440,NonExistentProduct,Home & Garden,Decor,364.01,309,99,210
4441,Jamie,InvalidCategory,Fiction,930.3,213,85,128
4442,Anthony,Books,Academic,693.39,392,58,334
4443,Marvin,Clothing,Shirt,995.13,127,88,39
4444,Anthony,Books,Academic,693.39,274,74,200
4445,NonExistentProduct,InvalidCategory,Shirt,995.13,477,127,350
4446,Shawn,Electronics,Headphones,461.09,332,199,133
4447,Fred,Books,Academic,951.53,165,116,49
4448,Elizabeth,Clothing,Shirt,840.19,228,201,27
4449,Shannon,Home & Garden,Gardening Tools,68.01,164,45,119
4450,Pamela,Electronics,Headphones,651.11,397,62,335
4451,NonExistentProduct,Electronics,Headphones,660.05,305,55,250
4452,Marvin,Clothing,Shirt,995.13,475,334,141
4453,Anthony,Books,Academic,693.39,227,23,204
4454,Justin,Electronics,Headphones,660.05,359,323,36
4455,Jamie,Books,Fiction,930.3,192,118,74
4456,Shawn,Electronics,Headphones,461.09,228,134,94
4457,Elizabeth,Clothing,Shirt,99999.99,94,17,77
4458,Elizabeth,Clothing,Shirt,840.19,298,116,182
4459,Martha,InvalidCategory,Fiction,InvalidPrice,413,234,179
4460,Michael,Toys,Dolls,46.23,56,17,39
4461,NonExistentProduct,Clothing,Shirt,995.13,222,206,16
4462,Marvin,Clothing,Shirt,995.13,255,140,115
4463,Marvin,Clothing,Shirt,995.13,290,101,189
4464,Pamela,Electronics,Headphones,651.11,396,66,330
4465,Justin,Electronics,Headphones,660.05,185,168,17
4466,Pamela,Electronics,Headphones,InvalidPrice,84,75,9
4467,Katie,InvalidCategory,Non-fiction,642.11,254,168,86
4468,Robert,Electronics,Mobile,847.43,349,235,114
4469,NonExistentProduct,Electronics,Camera,652.35,71,39,32
4470,Martha,Books,Fiction,433.1,101,40,61
4471,Fred,InvalidCategory,Academic,951.53,63,49,14
4472,Justin,Electronics,Headphones,660.05,277,59,218
4473,Nathaniel,InvalidCategory,Camera,652.35,70,51,19
4474,Robert,InvalidCategory,Mobile,847.43,240,21,219
4475,Katie,Books,Non-fiction,99999.99,447,327,120
4476,Shannon,Home & Garden,Gardening Tools,InvalidPrice,185,25,160
4477,Kristine,InvalidCategory,Headphones,228.82,307,158,149
4478,Katie,Books,Non-fiction,642.11,493,112,381
4479,Nathaniel,Electronics,Camera,652.35,168,123,45
4480,Martha,Books,Fiction,433.1,445,204,241
4481,Nathaniel,Electronics,Camera,652.35,412,395,17
4482,NonExistentProduct,Home & Garden,Gardening Tools,99999.99,82,5,77
4483,Kristine,Electronics,Headphones,228.82,250,198,52
4484,Anthony,Books,Academic,69339.0,281,173,108
4485,Nathaniel,Electronics,Camera,0.01,267,241,26
4486,Shawn,Electronics,Headphones,InvalidPrice,321,76,245
4487,Shawn,Electronics,Headphones,461.09,71,38,33
4488,NonExistentProduct,Books,Academic,951.53,150,109,41
4489,Shannon,Home & Garden,Gardening Tools,68.01,406,333,73
4490,Fred,Books,Academic,951.53,452,404,48
4491,Justin,Electronics,Headphones,660.05,471,393,78
4492,Elizabeth,Clothing,Shirt,840.19,315,71,244
4493,Justin,InvalidCategory,Headphones,660.05,134,8,126
4494,Elizabeth,Clothing,Shirt,840.19,464,454,10
4495,Nathaniel,Electronics,Camera,InvalidPrice,69,65,4
4496,Angela,Toys,Action Figures,386.57,69,13,56
4497,Wanda,Toys,Educational,268.61,341,13,328
4498,Pamela,Electronics,Headphones,InvalidPrice,241,139,102
4499,Angela,Toys,Action Figures,386.57,236,146,90
4500,Kristine,InvalidCategory,Headphones,InvalidPrice,393,216,177
4501,Pamela,Electronics,Headphones,651.11,156,110,46
4502,NonExistentProduct,Electronics,Mobile,847.43,127,98,29
4503,Amy,Home & Garden,Decor,36401.0,81,2,79
4504,Jamie,Books,Fiction,930.3,211,98,113
4505,Wanda,Toys,Educational,268.61,223,41,182
4506,NonExistentProduct,Electronics,Camera,652.35,492,170,322
4507,Jamie,Books,Fiction,930.3,119,82,37
4508,Angela,Toys,Action Figures,386.57,161,80,81
4509,Kristine,Electronics,Headphones,228.82,190,132,58
4510,Tammy,InvalidCategory,Furniture,99999.99,365,321,44
4511,Elizabeth,Clothing,Shirt,840.19,217,167,50
4512,Martha,InvalidCategory,Fiction,433.1,382,295,87
4513,Martha,Books,Fiction,433.1,430,347,83
4514,Michael,Toys,Dolls,46.23,74,32,42
4515,Amy,Home & Garden,Decor,364.01,284,200,84
4516,NonExistentProduct,Clothing,Shirt,995.13,95,61,34
4517,Robert,InvalidCategory,Mobile,847.43,72,58,14
4518,Shannon,Home & Garden,Gardening Tools,68.01,396,260,136
4519,Shannon,Home & Garden,Gardening Tools,99999.99,411,343,68
4520,Pamela,InvalidCategory,Headphones,651.11,354,170,184
4521,Shawn,Electronics,Headphones,461.09,472,390,82
4522,Fred,Books,Academic,99999.99,52,21,31
4523,Elizabeth,Clothing,Shirt,84019.0,261,77,184
4524,Tammy,Home & Garden,Furniture,InvalidPrice,451,393,58
4525,Shawn,Electronics,Headphones,461.09,262,46,216
4526,Cynthia,Electronics,Headphones,872.85,347,232,115
4527,Anthony,InvalidCategory,Academic,99999.99,483,107,376
4528,Jamie,Books,Fiction,930.3,108,51,57
4529,Angela,Toys,Action Figures,386.57,151,61,90
4530,Anthony,Books,Academic,693.39,122,98,24
4531,Marvin,Clothing,Shirt,995.13,461,394,67
4532,Amy,InvalidCategory,Decor,364.01,416,255,161
4533,Pamela,InvalidCategory,Headphones,651.11,116,116,0
4534,Katie,Books,Non-fiction,642.11,265,173,92
4535,Shawn,Electronics,Headphones,461.09,404,141,263
4536,Nathaniel,Electronics,Camera,652.35,330,282,48
4537,Elizabeth,Clothing,Shirt,840.19,421,73,348
4538,Nathaniel,InvalidCategory,Camera,InvalidPrice,471,251,220
4539,Elizabeth,Clothing,Shirt,840.19,368,141,227
4540,Cynthia,InvalidCategory,Headphones,0.01,494,259,235
4541,Anthony,Books,Academic,69339.0,367,187,180
4542,Tammy,Home & Garden,Furniture,431.82,131,23,108
4543,Nathaniel,Electronics,Camera,652.35,161,20,141
4544,Katie,InvalidCategory,Non-fiction,642.11,276,72,204
4545,NonExistentProduct,Books,Non-fiction,InvalidPrice,426,376,50
4546,Shawn,Electronics,Headphones,461.09,245,179,66
4547,Anthony,Books,Academic,693.39,472,73,399
4548,Elizabeth,Clothing,Shirt,840.19,202,42,160
4549,Shannon,Home & Garden,Gardening Tools,0.01,171,71,100
4550,Martha,Books,Fiction,InvalidPrice,487,151,336
4551,Katie,Books,Non-fiction,642.11,221,8,213
4552,Anthony,Books,Academic,69339.0,138,69,69
4553,Tammy,Home & Garden,Furniture,431.82,479,23,456
4554,Michael,Toys,Dolls,46.23,109,98,11
4555,Martha,Books,Fiction,433.1,105,56,49
4556,Shannon,InvalidCategory,Gardening Tools,68.01,200,48,152
4557,Cynthia,Electronics,Headphones,872.85,405,320,85
4558,Elizabeth,InvalidCategory,Shirt,840.19,58,24,34
4559,Michael,InvalidCategory,Dolls,46.23,288,16,272
4560,Martha,Books,Fiction,433.1,429,347,82
4561,Anthony,Books,Academic,693.39,363,264,99
4562,Fred,Books,Academic,95153.0,364,65,299
4563,Fred,Books,Academic,951.53,397,294,103
4564,Fred,Books,Academic,951.53,301,54,247
4565,Martha,Books,Fiction,InvalidPrice,50,50,0
4566,Shawn,Electronics,Headphones,461.09,472,222,250
4567,Justin,Electronics,Headphones,660.05,229,2,227
4568,NonExistentProduct,Electronics,Headphones,461.09,255,171,84
4569,Elizabeth,Clothing,Shirt,840.19,338,111,227
4570,Cynthia,Electronics,Headphones,InvalidPrice,259,67,192
4571,Tammy,Home & Garden,Furniture,431.82,177,33,144
4572,Tammy,Home & Garden,Furniture,431.82,456,60,396
4573,Justin,InvalidCategory,Headphones,660.05,356,97,259
4574,Cynthia,Electronics,Headphones,872.85,465,265,200
4575,Katie,Books,Non-fiction,0.01,324,182,142
4576,Shannon,Home & Garden,Gardening Tools,6801.000000000001,470,293,177
4577,Pamela,Electronics,Headphones,InvalidPrice,77,56,21
4578,Michael,Toys,Dolls,46.23,378,122,256
4579,Tammy,Home & Garden,Furniture,431.82,200,15,185
4580,Jamie,Books,Fiction,0.01,404,402,2
4581,Angela,Toys,Action Figures,InvalidPrice,492,282,210
4582,Anthony,Books,Academic,99999.99,295,79,216
4583,NonExistentProduct,Home & Garden,Decor,InvalidPrice,441,229,212
4584,Cynthia,InvalidCategory,Headphones,872.85,342,174,168
4585,Nathaniel,Electronics,Camera,652.35,367,132,235
4586,Shawn,Electronics,Headphones,461.09,189,187,2
4587,Marvin,Clothing,Shirt,995.13,220,118,102
4588,Kristine,Electronics,Headphones,228.82,153,49,104
4589,NonExistentProduct,Books,Fiction,930.3,141,133,8
4590,Kristine,Electronics,Headphones,228.82,162,18,144
4591,Katie,Books,Non-fiction,642.11,465,95,370
4592,Fred,Books,Academic,951.53,448,184,264
4593,Shawn,Electronics,Headphones,461.09,421,210,211
4594,Marvin,Clothing,Shirt,0.01,380,285,95
4595,Cynthia,Electronics,Headphones,87285.0,176,157,19
4596,Katie,Books,Non-fiction,64211.0,317,84,233
4597,Michael,Toys,Dolls,InvalidPrice,60,30,30
4598,Jamie,Books,Fiction,930.3,207,136,71
4599,NonExistentProduct,InvalidCategory,Headphones,99999.99,213,67,146
4600,Cynthia,Electronics,Headphones,872.85,85,23,62
4601,NonExistentProduct,Electronics,Headphones,87285.0,460,147,313
4602,Jamie,Books,Fiction,930.3,135,91,44
4603,Robert,Electronics,Mobile,84743.0,146,113,33
4604,Wanda,Toys,Educational,268.61,69,51,18
4605,Angela,Toys,Action Figures,386.57,478,320,158
4606,Nathaniel,Electronics,Camera,652.35,317,160,157
4607,Nathaniel,InvalidCategory,Camera,InvalidPrice,50,41,9
4608,Marvin,Clothing,Shirt,0.01,254,96,158
4609,Tammy,Home & Garden,Furniture,43182.0,108,14,94
4610,Angela,InvalidCategory,Action Figures,386.57,52,51,1
4611,Marvin,InvalidCategory,Shirt,995.13,53,24,29
4612,Fred,Books,Academic,InvalidPrice,171,97,74
4613,Kristine,Electronics,Headphones,InvalidPrice,347,235,112
4614,Shannon,Home & Garden,Gardening Tools,99999.99,290,266,24
4615,Angela,Toys,Action Figures,386.57,92,22,70
4616,Martha,Books,Fiction,433.1,295,181,114
4617,Wanda,InvalidCategory,Educational,268.61,438,99,339
4618,Angela,Toys,Action Figures,386.57,74,39,35
4619,Anthony,Books,Academic,InvalidPrice,233,188,45
4620,Marvin,Clothing,Shirt,995.13,255,98,157
4621,Nathaniel,Electronics,Camera,652.35,101,5,96
4622,Angela,Toys,Action Figures,386.57,96,96,0
4623,Michael,Toys,Dolls,46.23,391,243,148
4624,Jamie,Books,Fiction,930.3,256,165,91
4625,Wanda,Toys,Educational,26861.0,70,30,40
4626,Angela,Toys,Action Figures,InvalidPrice,432,53,379
4627,Elizabeth,Clothing,Shirt,840.19,312,12,300
4628,NonExistentProduct,Toys,Educational,268.61,386,247,139
4629,Tammy,Home & Garden,Furniture,InvalidPrice,410,230,180
4630,Wanda,Toys,Educational,268.61,217,82,135
4631,Anthony,Books,Academic,693.39,443,442,1
4632,NonExistentProduct,Books,Non-fiction,642.11,228,39,189
4633,Katie,Books,Non-fiction,642.11,454,243,211
4634,Robert,Electronics,Mobile,847.43,385,205,180
4635,Anthony,Books,Academic,693.39,125,116,9
4636,Elizabeth,Clothing,Shirt,0.01,473,317,156
4637,Anthony,Books,Academic,693.39,370,15,355
4638,Elizabeth,Clothing,Shirt,840.19,217,118,99
4639,Justin,Electronics,Headphones,InvalidPrice,409,31,378
4640,NonExistentProduct,Books,Fiction,433.1,163,81,82
4641,Pamela,Electronics,Headphones,651.11,51,25,26
4642,Angela,Toys,Action Figures,386.57,142,138,4
4643,Cynthia,Electronics,Headphones,87285.0,452,347,105
4644,Shawn,Electronics,Headphones,461.09,366,125,241
4645,Robert,Electronics,Mobile,847.43,200,69,131
4646,Martha,Books,Fiction,InvalidPrice,246,61,185
4647,Katie,Books,Non-fiction,642.11,286,261,25
4648,Shannon,Home & Garden,Gardening Tools,68.01,418,102,316
4649,Michael,Toys,Dolls,99999.99,100,44,56
4650,Nathaniel,Electronics,Camera,652.35,121,68,53
4651,Pamela,Electronics,Headphones,65111.0,279,96,183
4652,Shannon,Home & Garden,Gardening Tools,68.01,170,77,93
4653,Nathaniel,Electronics,Camera,652.35,492,376,116
4654,Amy,Home & Garden,Decor,364.01,52,52,0
4655,NonExistentProduct,Home & Garden,Furniture,InvalidPrice,372,115,257
4656,Michael,Toys,Dolls,InvalidPrice,341,30,311
4657,Tammy,Home & Garden,Furniture,431.82,130,2,128
4658,Kristine,Electronics,Headphones,228.82,92,54,38
4659,Robert,Electronics,Mobile,84743.0,252,240,12
4660,Katie,Books,Non-fiction,InvalidPrice,275,250,25
4661,Elizabeth,Clothing,Shirt,840.19,409,146,263
4662,Kristine,Electronics,Headphones,228.82,359,74,285
4663,Elizabeth,Clothing,Shirt,0.01,434,106,328
4664,Amy,Home & Garden,Decor,36401.0,317,90,227
4665,Angela,Toys,Action Figures,386.57,397,162,235
4666,Wanda,Toys,Educational,268.61,230,129,101
4667,Fred,Books,Academic,951.53,109,28,81
4668,Elizabeth,Clothing,Shirt,InvalidPrice,337,269,68
4669,Marvin,Clothing,Shirt,99513.0,496,421,75
4670,Nathaniel,Electronics,Camera,65235.0,405,52,353
4671,Marvin,Clothing,Shirt,99513.0,328,104,224
4672,Shannon,Home & Garden,Gardening Tools,68.01,291,58,233
4673,Elizabeth,Clothing,Shirt,840.19,308,100,208
4674,Nathaniel,Electronics,Camera,652.35,433,25,408
4675,Michael,Toys,Dolls,46.23,464,421,43
4676,Justin,InvalidCategory,Headphones,0.01,401,72,329
4677,Kristine,Electronics,Headphones,22882.0,462,376,86
4678,NonExistentProduct,Electronics,Headphones,66005.0,325,194,131
4679,NonExistentProduct,InvalidCategory,Decor,364.01,197,73,124
4680,Kristine,Electronics,Headphones,99999.99,487,213,274
4681,NonExistentProduct,Books,Fiction,InvalidPrice,173,88,85
4682,Angela,Toys,Action Figures,386.57,339,4,335
4683,Marvin,Clothing,Shirt,995.13,335,127,208
4684,Anthony,Books,Academic,99999.99,432,265,167
4685,Pamela,InvalidCategory,Headphones,651.11,334,128,206
4686,Jamie,Books,Fiction,930.3,51,10,41
4687,Elizabeth,Clothing,Shirt,840.19,200,186,14
4688,Pamela,InvalidCategory,Headphones,65111.0,226,224,2
4689,Nathaniel,Electronics,Camera,652.35,437,302,135
4690,NonExistentProduct,Home & Garden,Decor,364.01,304,7,297
4691,Wanda,Toys,Educational,268.61,313,276,37
4692,Amy,Home & Garden,Decor,364.01,186,69,117
4693,Angela,Toys,Action Figures,386.57,175,22,153
4694,Shawn,Electronics,Headphones,461.09,143,7,136
4695,Angela,Toys,Action Figures,386.57,235,44,191
4696,Tammy,Home & Garden,Furniture,43182.0,106,58,48
4697,Elizabeth,Clothing,Shirt,840.19,334,138,196
4698,NonExistentProduct,Home & Garden,Furniture,431.82,341,160,181
4699,NonExistentProduct,Electronics,Headphones,99999.99,146,7,139
4700,NonExistentProduct,Clothing,Shirt,995.13,318,97,221
4701,Jamie,Books,Fiction,930.3,336,144,192
4702,Cynthia,Electronics,Headphones,872.85,409,83,326
4703,Jamie,InvalidCategory,Fiction,0.01,105,60,45
4704,Fred,Books,Academic,951.53,343,262,81
4705,Marvin,Clothing,Shirt,99999.99,219,124,95
4706,Jamie,Books,Fiction,99999.99,375,238,137
4707,Angela,InvalidCategory,Action Figures,386.57,357,316,41
4708,Martha,Books,Fiction,433.1,143,7,136
4709,Tammy,Home & Garden,Furniture,431.82,273,35,238
4710,Katie,Books,Non-fiction,642.11,276,222,54
4711,Pamela,Electronics,Headphones,651.11,91,53,38
4712,Shawn,Electronics,Headphones,461.09,233,118,115
4713,Cynthia,Electronics,Headphones,872.85,138,62,76
4714,Angela,Toys,Action Figures,386.57,111,12,99
4715,Tammy,Home & Garden,Furniture,0.01,112,49,63
4716,NonExistentProduct,Clothing,Shirt,840.19,465,174,291
4717,Kristine,Electronics,Headphones,228.82,337,315,22
4718,Nathaniel,Electronics,Camera,652.35,140,76,64
4719,Justin,Electronics,Headphones,660.05,439,273,166
4720,Elizabeth,InvalidCategory,Shirt,840.19,398,233,165
4721,Shawn,Electronics,Headphones,461.09,427,216,211
4722,Shannon,Home & Garden,Gardening Tools,99999.99,403,272,131
4723,Anthony,InvalidCategory,Academic,693.39,351,342,9
4724,Wanda,Toys,Educational,268.61,330,279,51
4725,Marvin,Clothing,Shirt,99999.99,423,211,212
4726,Cynthia,Electronics,Headphones,872.85,150,66,84
4727,Jamie,Books,Fiction,930.3,386,175,211
4728,Wanda,Toys,Educational,268.61,97,87,10
4729,Robert,Electronics,Mobile,84743.0,124,4,120
4730,Martha,Books,Fiction,433.1,358,58,300
4731,Marvin,Clothing,Shirt,995.13,322,130,192
4732,Amy,Home & Garden,Decor,InvalidPrice,266,176,90
4733,Wanda,Toys,Educational,268.61,98,68,30
4734,Nathaniel,Electronics,Camera,652.35,185,60,125
4735,Martha,Books,Fiction,433.1,125,32,93
4736,Elizabeth,Clothing,Shirt,840.19,60,56,4
4737,Fred,Books,Academic,95153.0,216,55,161
4738,Fred,Books,Academic,951.53,399,7,392
4739,Nathaniel,Electronics,Camera,652.35,407,157,250
4740,Fred,InvalidCategory,Academic,951.53,111,69,42
4741,Angela,Toys,Action Figures,386.57,328,168,160
4742,Cynthia,Electronics,Headphones,872.85,103,10,93
4743,Justin,Electronics,Headphones,66005.0,98,34,64
4744,NonExistentProduct,Electronics,Headphones,InvalidPrice,347,265,82
4745,Martha,Books,Fiction,433.1,170,67,103
4746,Cynthia,Electronics,Headphones,872.85,203,124,79
4747,Angela,Toys,Action Figures,386.57,184,75,109
4748,Elizabeth,Clothing,Shirt,0.01,158,141,17
4749,Nathaniel,Electronics,Camera,652.35,258,25,233
4750,Anthony,Books,Academic,693.39,123,110,13
4751,Jamie,Books,Fiction,InvalidPrice,73,10,63
4752,Pamela,Electronics,Headphones,651.11,145,115,30
4753,Justin,Electronics,Headphones,660.05,166,158,8
4754,Michael,Toys,Dolls,46.23,120,107,13
4755,Anthony,Books,Academic,99999.99,220,66,154
4756,Anthony,Books,Academic,693.39,61,48,13
4757,Martha,Books,Fiction,433.1,241,134,107
4758,Elizabeth,Clothing,Shirt,99999.99,480,338,142
4759,Tammy,Home & Garden,Furniture,431.82,466,421,45
4760,Angela,Toys,Action Figures,InvalidPrice,405,346,59
4761,Justin,Electronics,Headphones,99999.99,393,309,84
4762,Wanda,Toys,Educational,268.61,281,167,114
4763,Fred,Books,Academic,95153.0,456,40,416
4764,Jamie,Books,Fiction,930.3,432,194,238
4765,Martha,Books,Fiction,433.1,421,169,252
4766,NonExistentProduct,Electronics,Camera,652.35,401,16,385
4767,Pamela,Electronics,Headphones,65111.0,105,96,9
4768,Tammy,Home & Garden,Furniture,0.01,355,346,9
4769,Wanda,Toys,Educational,268.61,422,378,44
4770,Michael,InvalidCategory,Dolls,46.23,192,125,67
4771,NonExistentProduct,Toys,Dolls,46.23,471,62,409
4772,Michael,Toys,Dolls,46.23,325,244,81
4773,Justin,Electronics,Headphones,660.05,147,123,24
4774,Tammy,Home & Garden,Furniture,InvalidPrice,494,268,226
4775,NonExistentProduct,Toys,Educational,268.61,270,183,87
4776,Katie,InvalidCategory,Non-fiction,642.11,276,226,50
4777,Martha,Books,Fiction,InvalidPrice,398,262,136
4778,Jamie,Books,Fiction,930.3,149,105,44
4779,Shannon,Home & Garden,Gardening Tools,68.01,139,45,94
4780,Cynthia,Electronics,Headphones,87285.0,163,143,20
4781,Marvin,InvalidCategory,Shirt,995.13,366,282,84
4782,Jamie,Books,Fiction,930.3,405,382,23
4783,Pamela,Electronics,Headphones,651.11,128,57,71
4784,Elizabeth,Clothing,Shirt,840.19,475,335,140
4785,Nathaniel,Electronics,Camera,652.35,321,47,274
4786,Fred,Books,Academic,951.53,202,67,135
4787,Justin,Electronics,Headphones,660.05,428,355,73
4788,Jamie,Books,Fiction,930.3,261,152,109
4789,Robert,Electronics,Mobile,847.43,129,42,87
4790,Katie,Books,Non-fiction,642.11,280,100,180
4791,Nathaniel,Electronics,Camera,652.35,221,71,150
4792,Wanda,Toys,Educational,268.61,66,31,35
4793,Amy,InvalidCategory,Decor,36401.0,69,47,22
4794,Fred,Books,Academic,951.53,435,77,358
4795,Nathaniel,Electronics,Camera,652.35,349,200,149
4796,Michael,Toys,Dolls,46.23,308,23,285
4797,Shawn,Electronics,Headphones,461.09,271,83,188
4798,Wanda,InvalidCategory,Educational,268.61,177,130,47
4799,Shawn,Electronics,Headphones,461.09,485,1,484
4800,Marvin,Clothing,Shirt,0.01,378,186,192
4801,Michael,Toys,Dolls,46.23,187,48,139
4802,Katie,Books,Non-fiction,642.11,347,68,279
4803,NonExistentProduct,InvalidCategory,Dolls,46.23,399,324,75
4804,Jamie,Books,Fiction,930.3,454,66,388
4805,Amy,Home & Garden,Decor,364.01,124,105,19
4806,Amy,InvalidCategory,Decor,99999.99,343,188,155
4807,Fred,InvalidCategory,Academic,951.53,267,121,146
4808,Wanda,Toys,Educational,26861.0,379,99,280
4809,Jamie,Books,Fiction,930.3,164,114,50
4810,Katie,Books,Non-fiction,99999.99,153,47,106
4811,Nathaniel,Electronics,Camera,65235.0,178,55,123
4812,Shawn,Electronics,Headphones,461.09,222,31,191
4813,Justin,Electronics,Headphones,660.05,282,274,8
4814,Kristine,InvalidCategory,Headphones,228.82,463,113,350
4815,Angela,Toys,Action Figures,386.57,281,130,151
4816,Tammy,Home & Garden,Furniture,431.82,307,190,117
4817,NonExistentProduct,Toys,Dolls,46.23,176,80,96
4818,Wanda,Toys,Educational,268.61,53,19,34
4819,Justin,Electronics,Headphones,660.05,229,21,208
4820,Katie,Books,Non-fiction,642.11,304,246,58
4821,Martha,Books,Fiction,433.1,72,1,71
4822,Pamela,Electronics,Headphones,65111.0,355,301,54
4823,Shannon,Home & Garden,Gardening Tools,68.01,481,384,97
4824,Jamie,Books,Fiction,93030.0,263,204,59
4825,NonExistentProduct,Books,Fiction,930.3,217,36,181
4826,Cynthia,Electronics,Headphones,872.85,216,190,26
4827,Justin,Electronics,Headphones,660.05,157,122,35
4828,Wanda,Toys,Educational,268.61,70,12,58
4829,Martha,Books,Fiction,43310.0,276,209,67
4830,Shannon,Home & Garden,Gardening Tools,68.01,140,4,136
4831,Nathaniel,Electronics,Camera,652.35,120,93,27
4832,NonExistentProduct,Toys,Dolls,46.23,486,77,409
4833,Fred,Books,Academic,951.53,378,364,14
4834,Michael,Toys,Dolls,InvalidPrice,96,59,37
4835,Cynthia,Electronics,Headphones,872.85,61,11,50
4836,Wanda,Toys,Educational,268.61,442,335,107
4837,Michael,Toys,Dolls,46.23,75,13,62
4838,NonExistentProduct,Electronics,Headphones,660.05,417,130,287
4839,Pamela,Electronics,Headphones,651.11,112,87,25
4840,Elizabeth,Clothing,Shirt,840.19,108,49,59
4841,Kristine,Electronics,Headphones,228.82,248,36,212
4842,Elizabeth,Clothing,Shirt,840.19,50,50,0
4843,Robert,Electronics,Mobile,847.43,350,125,225
4844,Fred,Books,Academic,951.53,164,73,91
4845,Anthony,InvalidCategory,Academic,693.39,254,253,1
4846,Elizabeth,Clothing,Shirt,0.01,472,73,399
4847,Tammy,InvalidCategory,Furniture,431.82,351,197,154
4848,NonExistentProduct,Toys,Educational,268.61,150,71,79
4849,Wanda,Toys,Educational,0.01,367,233,134
4850,Angela,Toys,Action Figures,InvalidPrice,80,46,34
4851,Shannon,Home & Garden,Gardening Tools,68.01,114,101,13
4852,Anthony,Books,Academic,693.39,439,249,190
4853,Anthony,Books,Academic,693.39,239,71,168
4854,Tammy,Home & Garden,Furniture,431.82,348,241,107
4855,Michael,Toys,Dolls,46.23,428,84,344
4856,Michael,Toys,Dolls,46.23,285,283,2
4857,Justin,Electronics,Headphones,InvalidPrice,435,367,68
4858,Justin,Electronics,Headphones,660.05,249,99,150
4859,Robert,Electronics,Mobile,847.43,500,214,286
4860,Marvin,Clothing,Shirt,995.13,348,242,106
4861,Amy,Home & Garden,Decor,364.01,200,23,177
4862,Fred,Books,Academic,99999.99,329,163,166
4863,Elizabeth,Clothing,Shirt,840.19,252,56,196
4864,Jamie,Books,Fiction,930.3,336,240,96
4865,Martha,Books,Fiction,43310.0,223,21,202
4866,Amy,Home & Garden,Decor,364.01,163,77,86
4867,Anthony,Books,Academic,693.39,211,20,191
4868,Fred,Books,Academic,InvalidPrice,466,326,140
4869,Shawn,Electronics,Headphones,99999.99,372,361,11
4870,Angela,InvalidCategory,Action Figures,386.57,320,291,29
4871,Jamie,Books,Fiction,0.01,195,138,57
4872,Shawn,Electronics,Headphones,461.09,89,38,51
4873,Shannon,Home & Garden,Gardening Tools,InvalidPrice,231,11,220
4874,Elizabeth,InvalidCategory,Shirt,840.19,139,99,40
4875,Shawn,Electronics,Headphones,461.09,362,136,226
4876,Anthony,Books,Academic,693.39,338,233,105
4877,Tammy,Home & Garden,Furniture,431.82,72,61,11
4878,Jamie,Books,Fiction,930.3,415,130,285
4879,Angela,Toys,Action Figures,38657.0,230,182,48
4880,Michael,Toys,Dolls,46.23,290,43,247
4881,Kristine,Electronics,Headphones,228.82,73,26,47
4882,Jamie,Books,Fiction,930.3,232,124,108
4883,Shawn,InvalidCategory,Headphones,461.09,172,94,78
4884,Anthony,Books,Academic,693.39,481,182,299
4885,Anthony,Books,Academic,693.39,112,6,106
4886,Tammy,Home & Garden,Furniture,431.82,497,376,121
4887,Michael,Toys,Dolls,46.23,339,238,101
4888,NonExistentProduct,Electronics,Headphones,872.85,112,26,86
4889,Michael,Toys,Dolls,46.23,150,126,24
4890,NonExistentProduct,Electronics,Mobile,847.43,312,96,216
4891,Marvin,InvalidCategory,Shirt,995.13,188,70,118
4892,Marvin,Clothing,Shirt,995.13,433,58,375
4893,Cynthia,Electronics,Headphones,872.85,496,8,488
4894,Shawn,Electronics,Headphones,461.09,206,147,59
4895,Justin,Electronics,Headphones,InvalidPrice,283,140,143
4896,Jamie,Books,Fiction,930.3,182,33,149
4897,Shannon,Home & Garden,Gardening Tools,68.01,77,67,10
4898,Elizabeth,Clothing,Shirt,840.19,434,299,135
4899,Katie,Books,Non-fiction,642.11,301,55,246
4900,NonExistentProduct,Clothing,Shirt,840.19,478,321,157
4901,Justin,Electronics,Headphones,660.05,219,36,183
4902,NonExistentProduct,Toys,Educational,268.61,106,12,94
4903,Katie,Books,Non-fiction,64211.0,284,59,225
4904,Nathaniel,Electronics,Camera,652.35,268,213,55
4905,Amy,InvalidCategory,Decor,99999.99,144,38,106
4906,Marvin,Clothing,Shirt,995.13,79,36,43
4907,Fred,Books,Academic,951.53,224,214,10
4908,NonExistentProduct,Toys,Action Figures,386.57,281,16,265
4909,Kristine,Electronics,Headphones,228.82,388,94,294
4910,Pamela,Electronics,Headphones,651.11,480,287,193
4911,Pamela,InvalidCategory,Headphones,651.11,246,3,243
4912,Kristine,InvalidCategory,Headphones,InvalidPrice,434,358,76
4913,Amy,Home & Garden,Decor,364.01,484,107,377
4914,Martha,Books,Fiction,0.01,366,92,274
4915,Martha,Books,Fiction,433.1,491,245,246
4916,Marvin,Clothing,Shirt,99513.0,258,144,114
4917,Marvin,Clothing,Shirt,995.13,319,245,74
4918,Robert,Electronics,Mobile,847.43,68,58,10
4919,Cynthia,Electronics,Headphones,InvalidPrice,230,215,15
4920,Tammy,Home & Garden,Furniture,431.82,407,397,10
4921,NonExistentProduct,Electronics,Headphones,461.09,143,25,118
4922,Anthony,Books,Academic,693.39,383,117,266
4923,Fred,Books,Academic,951.53,455,166,289
4924,Anthony,Books,Academic,69339.0,328,89,239
4925,Cynthia,Electronics,Headphones,872.85,450,270,180
4926,Cynthia,Electronics,Headphones,0.01,477,176,301
4927,Robert,Electronics,Mobile,847.43,491,486,5
4928,Robert,Electronics,Mobile,847.43,208,193,15
4929,Cynthia,Electronics,Headphones,872.85,98,71,27
4930,Kristine,InvalidCategory,Headphones,22882.0,158,45,113
4931,NonExistentProduct,Books,Non-fiction,642.11,336,140,196
4932,Pamela,Electronics,Headphones,651.11,193,103,90
4933,Shannon,Home & Garden,Gardening Tools,68.01,296,131,165
4934,Michael,Toys,Dolls,46.23,481,76,405
4935,NonExistentProduct,InvalidCategory,Non-fiction,642.11,464,373,91
4936,Shannon,Home & Garden,Gardening Tools,InvalidPrice,334,283,51
4937,Martha,Books,Fiction,433.1,354,211,143
4938,Justin,Electronics,Headphones,660.05,76,38,38
4939,Angela,Toys,Action Figures,386.57,467,415,52
4940,Angela,Toys,Action Figures,InvalidPrice,65,39,26
4941,Katie,Books,Non-fiction,642.11,356,279,77
4942,Marvin,Clothing,Shirt,InvalidPrice,455,402,53
4943,Shannon,InvalidCategory,Gardening Tools,68.01,324,66,258
4944,Pamela,Electronics,Headphones,InvalidPrice,357,144,213
4945,NonExistentProduct,Electronics,Headphones,651.11,165,90,75
4946,Angela,Toys,Action Figures,386.57,280,152,128
4947,Marvin,Clothing,Shirt,995.13,386,157,229
4948,Nathaniel,Electronics,Camera,65235.0,306,3,303
4949,Michael,Toys,Dolls,46.23,175,15,160
4950,Kristine,InvalidCategory,Headphones,22882.0,226,87,139
4951,Robert,InvalidCategory,Mobile,847.43,436,174,262
4952,Kristine,InvalidCategory,Headphones,22882.0,326,302,24
4953,Anthony,Books,Academic,693.39,182,31,151
4954,Martha,Books,Fiction,433.1,419,392,27
4955,Wanda,Toys,Educational,268.61,307,102,205
4956,Amy,Home & Garden,Decor,InvalidPrice,268,185,83
4957,Elizabeth,Clothing,Shirt,84019.0,418,340,78
4958,Jamie,Books,Fiction,930.3,225,44,181
4959,Marvin,InvalidCategory,Shirt,995.13,480,251,229
4960,Angela,InvalidCategory,Action Figures,386.57,431,72,359
4961,Kristine,Electronics,Headphones,228.82,157,43,114
4962,Elizabeth,InvalidCategory,Shirt,84019.0,294,168,126
4963,Pamela,Electronics,Headphones,651.11,318,6,312
4964,Cynthia,Electronics,Headphones,872.85,429,360,69
4965,NonExistentProduct,Electronics,Headphones,651.11,196,127,69
4966,Cynthia,Electronics,Headphones,InvalidPrice,384,297,87
4967,Kristine,InvalidCategory,Headphones,228.82,158,125,33
4968,Katie,Books,Non-fiction,642.11,200,191,9
4969,Marvin,Clothing,Shirt,995.13,70,55,15
4970,Wanda,InvalidCategory,Educational,InvalidPrice,462,443,19
4971,NonExistentProduct,Home & Garden,Decor,364.01,444,211,233
4972,Robert,Electronics,Mobile,847.43,476,105,371
4973,Marvin,Clothing,Shirt,995.13,371,189,182
4974,Shannon,Home & Garden,Gardening Tools,0.01,378,240,138
4975,Angela,Toys,Action Figures,99999.99,248,4,244
4976,Elizabeth,Clothing,Shirt,840.19,415,412,3
4977,Shawn,Electronics,Headphones,46109.0,450,99,351
4978,Robert,Electronics,Mobile,847.43,61,57,4
4979,Tammy,InvalidCategory,Furniture,431.82,126,45,81
4980,NonExistentProduct,Electronics,Headphones,22882.0,427,272,155
4981,NonExistentProduct,Electronics,Headphones,InvalidPrice,389,221,168
4982,Tammy,InvalidCategory,Furniture,431.82,397,106,291
4983,Angela,Toys,Action Figures,386.57,164,73,91
4984,Nathaniel,Electronics,Camera,652.35,139,32,107
4985,Jamie,Books,Fiction,930.3,339,39,300
4986,Justin,Electronics,Headphones,660.05,70,62,8
4987,Robert,Electronics,Mobile,847.43,182,61,121
4988,Wanda,InvalidCategory,Educational,268.61,302,103,199
4989,Nathaniel,Electronics,Camera,652.35,406,305,101
4990,Anthony,Books,Academic,99999.99,93,18,75
4991,Wanda,Toys,Educational,0.01,367,39,328
4992,Angela,Toys,Action Figures,38657.0,113,90,23
4993,Angela,InvalidCategory,Action Figures,386.57,109,80,29
4994,Robert,Electronics,Mobile,847.43,287,260,27
4995,NonExistentProduct,Books,Non-fiction,642.11,113,2,111
4996,Justin,Electronics,Headphones,660.05,373,192,181
4997,Katie,Books,Non-fiction,642.11,133,38,95
4998,Jamie,Books,Fiction,930.3,181,49,132
4999,Angela,Toys,Action Figures,386.57,401,359,42
